!!!
!!!! MOST ENDING IN -ACH SHOULD BE IN ADJS ALSO LIKE CEILTEACH
!!!!
LEXICON NP-LEX-FAM
Aba	NP-Fam-V;
Abhartaigh	NP-Fam-chg;
Abóid	NP-Fam;
Achaidh	NP-Fam;
Ádaidh	NP-Fam;
Ádaigh	NP-Fam-chg;
Adaim	NP-Fam;
Adhaimh	NP-Fam;
Ádhaimh	NP-Fam;
Adhamhnáin	NP-Fam;
Adhastair	NP-Fam;
Aedhín	NP-Fam;
Ágáin	NP-Fam;
Agairt	NP-Fam;
Ágairt	NP-Fam;
Aghartaigh	NP-Fam;
Ághas	NP-Fam;
Aibhistín	NP-Fam;
Aibhne	NP-Fam;
Aibhril	NP-Fam;
Aiche	NP-Fam;
Aichir	NP-Fam;
Aidhne	NP-Fam;
Aidicín	NP-Fam;
Aidín	NP-Fam;
Aidí	NP-Fam;
Aifeáin	NP-Fam;
Aighleart	NP-Fam;
Aighlmear	NP-Fam;
Ailbheartaigh	NP-Fam-chg;
Ailche	NP-Fam;
Aileacháin	NP-Fam;
Aileagáin	NP-Fam;
Aileáin	NP-Fam;
Aileanáin	NP-Fam;
Áileasa	NP-Fam-V;
Ailile	NP-Fam;
Ailin	NP-Fam;
Ailín	NP-Fam;
Ailleacháin	NP-Fam;
Ailleagain	NP-Fam;
Ailmhic	NP-Fam;
Ailpíne	NP-Fam;
Ailpín	NP-Fam;
Aimhréidh	NP-Fam;
Ainbhith	NP-Fam;
Ainchín	NP-Fam;
Aindnú	NP-Fam;
Aindréis	NP-Fam;
Aindriú	NP-Fam;
Ainfidh	NP-Fam;
Aingleont	NP-Fam;
Ainifín	NP-Fam;
Áinle	NP-Fam;
Ainmheáin	NP-Fam;
Ainmhire	NP-Fam;
Ainqleont	NP-Fam;
Airchinnigh	NP-Fam-chg;
Airchinnigh	NP-Fam-chg;
Airchinn	NP-Fam;
Airchinn	NP-Fam;
Aíreachtaigh	NP-Fam;
Aireachtaigh	NP-Fam-chg;
Airgeadáin	NP-Fam;
Airigh	NP-Fam-chg;
Airmhí	NP-Fam;
Áirseabóid	NP-Fam;
Airséil	NP-Fam;
Áirséir	NP-Fam;
Airtgleont	NP-Fam;
Airtnéada	NP-Fam-V;
Aírtnéada	NP-Fam-V;
Airt	NP-Fam;
Aírt	NP-Fam;
Aírtrí	NP-Fam;
Áiseabóid	NP-Fam;
Aiséir	NP-Fam;
Aisí	NP-Fam;
Aislinn	NP-Fam;
Aistrigh	NP-Fam-chg;
Aitheasa	NP-Fam-V;
Aitigín	NP-Fam;
Alaman	NP-Fam;
Alard	NP-Fam;
Alastair	NP-Fam;
Alastair	NP-Fam;
Alastaír	NP-Fam;
Alastraim	NP-Fam;
Albanach	NP-Fam-0;
Alcóc	NP-Fam;
Allúin	NP-Fam;
Allúráin	NP-Fam;
Alsandair	NP-Fam;
Alsandair	NP-Fam;
Altún	NP-Fam;
Ámaill	NP-Fam;
Amainn	NP-Fam;
Ámainn	NP-Fam;
Ambróis	NP-Fam;
Ambrós	NP-Fam;
Amhalaí	NP-Fam;
Amhalaí	NP-Fam;
Amhlaoibh	NP-Fam;
Amhlaoibh	NP-Fam;
Amhráin	NP-Fam;
Amhráin	NP-Fam;
Amhsaigh	NP-Fam-chg;
Anabaí	NP-Fam;
Ancoitil	NP-Fam;
Andarsan	NP-Fam;
Anfaidh	NP-Fam;
Anglainn	NP-Fam;
Anlaoidh	NP-Fam;
Anluain	NP-Fam;
Annacháin	NP-Fam;
Annagáin	NP-Fam;
Annaidh	NP-Fam;
Annaidh	NP-Fam;
Annáin	NP-Fam;
Anracháin	NP-Fam;
Anrachtaigh	NP-Fam-chg;
Anradháin	NP-Fam;
Anragáin	NP-Fam;
Anraic	NP-Fam;
Anraic	NP-Fam;
Anraí	NP-Fam;
Anraoi	NP-Fam;
Antaine	NP-Fam;
Antaine	NP-Fam;
Aodha	NP-Fam;
Aodha	NP-Fam-V;
Aodha	NP-Fam-V;
Aogáin	NP-Fam;
Aogáin	NP-Fam;
Aogáin	NP-Fam;
Aoidh	NP-Fam;
Aoidh	NP-Fam;
Aoilleacháin	NP-Fam;
Aoláin	NP-Fam;
Aoláin	NP-Fam;
Aoláin	NP-Fam;
Aonáin	NP-Fam;
Aonais	NP-Fam;
Aonais	NP-Fam;
Aonasa	NP-Fam-V;
Aonasa	NP-Fam-V;
Aracháin	NP-Fam;
Arailt	NP-Fam;
Arascain	NP-Fam;
Arcail	NP-Fam;
Ardacha	NP-Fam-V;
Ardail	NP-Fam;
Argadáin	NP-Fam;
Argáin	NP-Fam;
Argáin	NP-Fam;
Argáin	NP-Fam;
Armaigh	NP-Fam-chg;
Armas	NP-Fam;
Arnóid	NP-Fam;
Arracháin	NP-Fam;
Arracháin	NP-Fam;
Arrachtáin	NP-Fam;
Arrachtáin	NP-Fam;
Arrachtáin	NP-Fam;
Arragáin	NP-Fam;
Arraith	NP-Fam;
Arraith	NP-Fam;
Artagáin	NP-Fam;
Artaigh	NP-Fam;
Artaigh	NP-Fam-chg;
Artaile	NP-Fam;
Artáin	NP-Fam;
Artáin	NP-Fam;
Artáin	NP-Fam;
Artair	NP-Fam;
Artúir	NP-Fam;
Ascaidh	NP-Fam;
Ascaill	NP-Fam;
Asmaint	NP-Fam;
Átaoi	NP-Fam;
Athairne	NP-Fam;
Athaírne	NP-Fam;
Bachlaigh	NP-Fam-chg;
Bacún	NP-Fam;
Baghcat	NP-Fam;
Bagóid	NP-Fam;
Báib	NP-Fam;
Báicéir	NP-Fam;
Bailinséir	NP-Fam;
Bailintín	NP-Fam;
Bailiste	NP-Fam;
Báille	NP-Fam;
Baimbric	NP-Fam;
Báin	NP-Fam;
Baíolláin	NP-Fam;
Bairéid	NP-Fam;
Bairéil	NP-Fam;
Bairr	NP-Fam;
Baiscinn	NP-Fam;
Baiséid	NP-Fam;
Baisnéid	NP-Fam;
Balbháin	NP-Fam;
Balbh	NP-Fam;
Baldún	NP-Fam;
Ballach	NP-Fam-0;
Ballard	NP-Fam;
Bál	NP-Fam;
Baltún	NP-Fam;
Bambaire	NP-Fam;
Banagáin	NP-Fam;
Banáin	NP-Fam;
Banáin	NP-Fam;
Bán	NP-Fam;
Baodáin	NP-Fam;
Baoill	NP-Fam;
Baoithin	NP-Fam;
Baoithín	NP-Fam;
Bardáin	NP-Fam;
Barear	NP-Fam;
Baróid	NP-Fam;
Barra	NP-Fam;
Bártaic	NP-Fam;
Bartún	NP-Fam;
Barún	NP-Fam;
Basca	NP-Fam-V;
Bastábla	NP-Fam;
Báth	NP-Fam;
Beacháin	NP-Fam;
Beacháin	NP-Fam;
Beagacháin	NP-Fam;
Beagáin	NP-Fam;
Beagáin	NP-Fam;
Beaglaoich	NP-Fam;
Béalatún	NP-Fam;
Béalatún	NP-Fam;
Beannacháin	NP-Fam;
Bearáin	NP-Fam;
Beara	NP-Fam-V;
Béara	NP-Fam-V;
Bearnabhál	NP-Fam;
Bearnáin	NP-Fam;
Bearnais	NP-Fam;
Bearthagra	NP-Fam-V;
Beartram	NP-Fam;
Béaslaí	NP-Fam;
Beastún	NP-Fam;
Beathan	NP-Fam;
Beatha	NP-Fam-V;
Beausang	NP-Fam;
Béice	NP-Fam;
Béice	NP-Fam;
Beieéid	NP-Fam;
Beie	NP-Fam;
Beigeáin	NP-Fam;
Beigléinn	NP-Fam;
Beig	NP-Fam;
Beig	NP-Fam;
Beilleagam	NP-Fam;
Beilliú	NP-Fam;
Beinéid	NP-Fam;
Beirgin	NP-Fam;
Beirn	NP-Fam;
Beirt	NP-Fam;
Beolláin	NP-Fam;


Bacstair	NP-Fam;
Baildrín	NP-Fam;
Bailis	NP-Fam;
Baird	NP-Fam;
Baldraithe	NP-Fam;
Ballaigh	NP-Fam-chg;
Bal	NP-Fam;
Bál	NP-Fam;
Balronta	NP-Fam-V;
Báltún	NP-Fam;
Barúin	NP-Fam;
Bearaigh	NP-Fam-chg;
Beardún	NP-Fam;
Bearshúiligh	NP-Fam-chg;
Beathan	NP-Fam;
Beatha	NP-Fam-V;
Béir	NP-Fam;
Bial	NP-Fam;
Biataigh	NP-Fam-chg;
Big	NP-Fam;
Biocáire	NP-Fam;
Bioráin	NP-Fam;
Bloscaidh	NP-Fam;
Bloscaire	NP-Fam;
Brádaigh	NP-Fam-chg;
Bradáin	NP-Fam;
Brain	NP-Fam;
Branaigh	NP-Fam-chg;
Brátha	NP-Fam-V;
Breatnaigh	NP-Fam-chg;
Breithimh	NP-Fam;
Breithiúnaigh	NP-Fam-chg;
Breithiún	NP-Fam;
Breithiún	NP-Fam;
Bríde	NP-Fam;
Broin	NP-Fam;
Bruadair	NP-Fam;
Buí	NP-Fam;

!!Bháin	NP-Fam;
!!Bhacstair	NP-Fam;
!!Bhaildrín	NP-Fam;
!!Bhailis	NP-Fam;
!!Bhaird	NP-Fam;
!!Bhaldraithe	NP-Fam;
!!Bhallaigh	NP-Fam-chg;
!!Bhal	NP-Fam;
!!Bhál	NP-Fam;
!!Bhalronta	NP-Fam-V;
!!Bháltún	NP-Fam;
!!Bharúin	NP-Fam;
!!Bhearaigh	NP-Fam-chg;
!!Bheardún	NP-Fam;
!!Bhearshúiligh	NP-Fam-chg;
!!Bheathan	NP-Fam;
!!Bheatha	NP-Fam-V;
!!Bhéir	NP-Fam;
!!Bhial	NP-Fam;
!!Bhiataigh	NP-Fam-chg;
!!Bhig	NP-Fam;
!!Bhiocáire	NP-Fam;
!!Bhioráin	NP-Fam;
!!Bhloscaidh	NP-Fam;
!!Bhloscaire	NP-Fam;
!!Bhrádaigh	NP-Fam-chg;
!!Bhradáin	NP-Fam;
!!Bhrain	NP-Fam;
!!Bhranaigh	NP-Fam-chg;
!!Bhrátha	NP-Fam-V;
!!Bhreatnaigh	NP-Fam-chg;
!!Bhreithimh	NP-Fam;
!!Bhreithiúnaigh	NP-Fam-chg;
!!Bhreithiún	NP-Fam;
!!Bhreithiún	NP-Fam;
!!Bhríde	NP-Fam;
!!Bhroin	NP-Fam;
!!Bhruadair	NP-Fam;
!!Bhuí	NP-Fam;
Biasta	NP-Fam-V;
Biataigh	NP-Fam-chg;
Bigigh	NP-Fam-chg;
Bigín	NP-Fam;
Bingeam	NP-Fam;
Binse	NP-Fam;
Bioma	NP-Fam-V;
Bioráin	NP-Fam;
Biorna	NP-Fam-V;
Birín	NP-Fam;
Blácam	NP-Fam;
Bláca	NP-Fam;
Blácual	NP-Fam;
Bláea	NP-Fam;
Blaghd	NP-Fam;
Blámhaic	NP-Fam;
Blaod	NP-Fam;
Blárach	NP-Fam-0;
Bléine	NP-Fam;
Blichín	NP-Fam;
Blí	NP-Fam;
Blóid	NP-Fam;
Bluinsín	NP-Fam;
Bodhráin	NP-Fam;
Bogaigh	NP-Fam-chg;
Bogáin	NP-Fam;
Bóidicín	NP-Fam;
Bóiléir	NP-Fam;
Bolguir	NP-Fam;
Bolguír	NP-Fam;
Bond	NP-Fam;
Bostóc	NP-Fam;
Bothún	NP-Fam;
Bót	NP-Fam;
!!bPaidir	NP-Fam;
Paidir	NP-Fam;
Bracháin	NP-Fam;
Bradacháin	NP-Fam;
Bradagáin	NP-Fam;
Brádaigh	NP-Fam-chg;
Bradail	NP-Fam;
Bradáin	NP-Fam;
Bradáin	NP-Fam;
Bragáin	NP-Fam;
Brair	NP-Fam;
Branagáin	NP-Fam;
Branaile	NP-Fam;
Branáin	NP-Fam;
Brannuibh	NP-Fam;
Brant	NP-Fam;
Braoin	NP-Fam;
Braonáin	NP-Fam;
Brátún	NP-Fam;
Breacáin	NP-Fam;
Bréadún	NP-Fam;
Brealláin	NP-Fam;
Breandáin	NP-Fam;
Breannóc	NP-Fam;
Bréartún	NP-Fam;
Breasail	NP-Fam;
Breasláin	NP-Fam;
Breathnach	NP-Fam-0;
Breatnach	NP-Fam-0;
Breatnaigh	NP-Fam-chg;
Breatún	NP-Fam;
Breithimh	NP-Fam;
Breithiúnaigh	NP-Fam-chg;
Breit	NP-Fam;
Bré	NP-Fam;
Briain	NP-Fam;
Briartaigh	NP-Fam-chg;
Briartaigh	NP-Fam-chg;
Bríde	NP-Fam;
Brie	NP-Fam;
Brig	NP-Fam;
Briosáin	NP-Fam;
Brioscú	NP-Fam;
Briotún	NP-Fam;
Brisleáin	NP-Fam;
Brit	NP-Fam;
Brochtún	NP-Fam;
Broc	NP-Fam;
Brogaidh	NP-Fam;
Brógáin	NP-Fam;
Broic	NP-Fam;
Broileacáin	NP-Fam;
Broiméil	NP-Fam;
Broin	NP-Fam;
Broin	NP-Fam;
Broisneacháin	NP-Fam;
Bróithe	NP-Fam;
Brolaigh	NP-Fam-chg;
Brólaigh	NP-Fam-chg;
Brolcháin	NP-Fam;
Bronnraigh	NP-Fam-chg;
Bronntaigh	NP-Fam-chg;
Brosnacháin	NP-Fam;
Bruachail	NP-Fam;
Bruacháin	NP-Fam;
Bruadair	NP-Fam;
Bruadau	NP-Fam;
Bruaidin	NP-Fam;
Bruaidí	NP-Fam;
Brúc	NP-Fam;
Brugha	NP-Fam-V;
Brún	NP-Fam;
Brú	NP-Fam;
Brús	NP-Fam;
Buachain	NP-Fam;
Buacháin	NP-Fam;
Buacháin	NP-Fam;
Buachalla	NP-Fam-V;
Buadáin	NP-Fam;
Buaigh	NP-Fam-chg;
Buamann	NP-Fam;
Búdrán	NP-Fam;
Builléid	NP-Fam;
Búille	NP-Fam;
Buinbhíol	NP-Fam;
Buinneán	NP-Fam;
Buirséil	NP-Fam;
Búiséir	NP-Fam;
Búiteach	NP-Fam-0;
Buitiméir	NP-Fam;
Buitléir	NP-Fam;
Bulfin	NP-Fam;
Búrbach	NP-Fam-0;
Búrca	NP-Fam;
Burdún	NP-Fam;
Burtún	NP-Fam;
Cába	NP-Fam-V;
Cadáin	NP-Fam;
Cadáin	NP-Fam;
Cadáin	NP-Fam;
Cadal	NP-Fam;
Cadal	NP-Fam;
Cadhain	NP-Fam;
Cadhain	NP-Fam;
Cadhla	NP-Fam-V;
Cafarra	NP-Fam-V;
Cailín	NP-Fam;
Cailín	NP-Fam;
Caimpion	NP-Fam;
Caingne	NP-Fam;
Cainin	NP-Fam;
Cainnia	NP-Fam-V;
Cáinte	NP-Fam;
Cairbre	NP-Fam;
Cairdín	NP-Fam;
Cairealláin	NP-Fam;
Caisealáin	NP-Fam;
Caisealáin	NP-Fam;
Caiside	NP-Fam;
Caiside	NP-Fam;
Caisil	NP-Fam;
Caisín	NP-Fam;
Cais	NP-Fam;
Calbhaigh	NP-Fam-chg;
Calbhaigh	NP-Fam-chg;
Calgaigh	NP-Fam-chg;
Calgaigh	NP-Fam-chg;
Callada	NP-Fam-V;
Callanáin	NP-Fam;
Callaráin	NP-Fam;
Calmáin	NP-Fam;
Camhaoil	NP-Fam;
Camhaoil	NP-Fam;
Camhraí	NP-Fam;
Camlaoich	NP-Fam;
Camshrón	NP-Fam;
Camtha	NP-Fam-V;
Canáin	NP-Fam;
Canann	NP-Fam;
Cana	NP-Fam-V;
Cantalún	NP-Fam;
Cantual	NP-Fam;
Cantún	NP-Fam;
Caocháin	NP-Fam;
Caochlaoich	NP-Fam;
Caochlaoich	NP-Fam;
Caoilte	NP-Fam;
Caoimhín	NP-Fam;
Caoimh	NP-Fam;
Caoindealáir	NP-Fam;
Caoinleáin	NP-Fam;
Caoinnealáin	NP-Fam;
Caoinnealbháin	NP-Fam;
Caolaí	NP-Fam;
Caollaí	NP-Fam;
Caomháin	NP-Fam;
Caomhánach	NP-Fam-0;
Caomhánach	NP-Fam-0;
Caomhánach	NP-Fam-0;
Caomhánaigh	NP-Fam-chg;
Caorthannáin	NP-Fam;
Caplais	NP-Fam;
Cardaigh	NP-Fam-chg;
Carduibh	NP-Fam;
Carduibh	NP-Fam;
Carlais	NP-Fam;
Carragáin	NP-Fam;
Carraidh	NP-Fam;
Carraín	NP-Fam;
Carráin	NP-Fam;
Carramhna	NP-Fam-V;
Carramhna	NP-Fam-V;
Carra	NP-Fam-V;
Carrún	NP-Fam;
Cartaine	NP-Fam;
Cárthaigh	NP-Fam-chg;
Casaile	NP-Fam;
Casáin	NP-Fam;
Casarlaigh	NP-Fam-chg;
Cas	NP-Fam;
Casthasaigh	NP-Fam-chg;
Cathail	NP-Fam;
Cathail	NP-Fam;
Cathailraibhaigh	NP-Fam-chg;
!!!Cathail Riabhaigh	NP-Fam-chg;
Catháin	NP-Fam;
Catháin	NP-Fam;
Cathaláin	NP-Fam;
Cathaoir	NP-Fam;
Cathaoir	NP-Fam;
Catharnaigh	NP-Fam-chg;
Catharnaigh	NP-Fam-chg;
Cathasaigh	NP-Fam-chg;
Cathláin	NP-Fam;
Cathluain	NP-Fam;
Cathmhaoil	NP-Fam;
Cat	NP-Fam;
Ceabhsa	NP-Fam;
Ceadagáin	NP-Fam;
Céadaigh	NP-Fam-chg;
Céadaigh	NP-Fam-chg;
Ceallacháin	NP-Fam;
Ceallacháin	NP-Fam;
Ceallaigh	NP-Fam-chg;
Ceamada	NP-Fam-V;
Ceanglaigh	NP-Fam-chg;
!!!!Ceann an Locha	NP-Fam-V;
Ceannannáin	NP-Fam;
Ceannt	NP-Fam;
Ceannuáin	NP-Fam;
Ceannuáin	NP-Fam;
Ceannubháin	NP-Fam;
Ceannubháin	NP-Fam;
Ceapóg	NP-Fam;
Ceapóg	NP-Fam;
Cearáin	NP-Fam;
Cearáin	NP-Fam;
Ceara	NP-Fam-V;
Cearbhaigh	NP-Fam-chg;
Cearbhaill	NP-Fam;
Cearbhail	NP-Fam;
Cearbháin	NP-Fam;
Cearbháin	NP-Fam;
Ceardaí	NP-Fam;
Cearmada	NP-Fam-V;
Cearnacháin	NP-Fam;
Cearnacháin	NP-Fam;
Cearnaigh	NP-Fam-chg;
Cearnaigh	NP-Fam-chg;
Cearrbhaigh	NP-Fam-chg;
Cearúill	NP-Fam;
Cearúil	NP-Fam;
Cearúlláin	NP-Fam;
Céataí	NP-Fam;
Céidigh	NP-Fam-chg;
Céifeacháin	NP-Fam;
Céifeachair	NP-Fam;
Céileacháin	NP-Fam;
Céileachair	NP-Fam;
Céile	NP-Fam;
Céin	NP-Fam;
Céirín	NP-Fam;
Céirín	NP-Fam;
Ceithearnaigh	NP-Fam-chg;
Céitinn	NP-Fam;
Céitin	NP-Fam;
Céitín	NP-Fam;
Ceit	NP-Fam;
Ceocháin	NP-Fam;
Ceocháin	NP-Fam;
Ceogáin	NP-Fam;
Ceoinín	NP-Fam;

Cabhóc	NP-Fam;
Caillín	NP-Fam;
Caíllín	NP-Fam;
Cainnigh	NP-Fam-chg;
Cainnigh	NP-Fam-chg;
Cáinte	NP-Fam;
Cairge	NP-Fam;
Cairge	NP-Fam;
Cais	NP-Fam;
Calbhaigh	NP-Fam-chg;
Caoich	NP-Fam;
caoin	NP-Fam;
Carraigh	NP-Fam-chg;
Carraigh	NP-Fam-chg;
Catáin	NP-Fam;
Catáin	NP-Fam;
Catáin	NP-Fam;
Cathair	NP-Fam;
Cathair	NP-Fam;
Ceairt	NP-Fam;
Ceallaigh	NP-Fam-chg;
Ceallaigh	NP-Fam-chg;
Cearáin	NP-Fam;
Ceara	NP-Fam-V;
Ceara	NP-Fam-V;
Céire	NP-Fam;
Ciaráin	NP-Fam;
Ciaráin	NP-Fam;
Circe	NP-Fam;
Claoin	NP-Fam;
Claoin	NP-Fam;
Cléirigh	NP-Fam-chg;
Cléirigh	NP-Fam-chg;
Cnoic	NP-Fam;
Coiligh	NP-Fam-chg;
Coiligh	NP-Fam-chg;
Coille	NP-Fam;
Coille	NP-Fam;
Coíllgh	NP-Fam;
Cóimdhe	NP-Fam;
Coiscle	NP-Fam;
Colaim	NP-Fam;
Colaim	NP-Fam;
Comain	NP-Fam;
Comáin	NP-Fam;
Comhaill	NP-Fam;
Comhaill	NP-Fam;
Comhain	NP-Fam;
Comhain	NP-Fam;
Cónaill	NP-Fam;
Críost	NP-Fam;
Crosáin	NP-Fam;
Cuda	NP-Fam-V;
Cuda	NP-Fam-V;
Cúille	NP-Fam;


!Chabhóc	NP-Fam;
!Chaillín	NP-Fam;
!Chaíllín	NP-Fam;
!Chainnigh	NP-Fam-chg;
!Chainnigh	NP-Fam-chg;
!Cháinte	NP-Fam;
!Chairge	NP-Fam;
!Chairge	NP-Fam;
!Chais	NP-Fam;
!Chalbhaigh	NP-Fam-chg;
!Chaoich	NP-Fam;
!Chaoin	NP-Fam;
!Chaoin	NP-Fam;
!Charraigh	NP-Fam-chg;
!Charraigh	NP-Fam-chg;
!Chatáin	NP-Fam;
!Chatáin	NP-Fam;
!Chatáin	NP-Fam;
!Chathair	NP-Fam;
!Chathair	NP-Fam;
!Cheairt	NP-Fam;
!Cheallaigh	NP-Fam-chg;
!Cheallaigh	NP-Fam-chg;
!Chearáin	NP-Fam;
!Cheara	NP-Fam-V;
!Cheara	NP-Fam-V;
!Chéire	NP-Fam;
!Chiaráin	NP-Fam;
!Chiaráin	NP-Fam;
!Chirce	NP-Fam;
!Chlaoin	NP-Fam;
!Chlaoin	NP-Fam;
!Chléirigh	NP-Fam-chg;
!Chléirigh	NP-Fam-chg;
!Chnoic	NP-Fam;
!Choiligh	NP-Fam-chg;
!Choiligh	NP-Fam-chg;
!Choille	NP-Fam;
!Choille	NP-Fam;
!Choíllgh	NP-Fam;
!Chóimdhe	NP-Fam;
!Choiscle	NP-Fam;
!Cholaim	NP-Fam;
!Cholaim	NP-Fam;
!Chomain	NP-Fam;
!Chomáin	NP-Fam;
!Chomhaill	NP-Fam;
!Chomhaill	NP-Fam;
!Chomhain	NP-Fam;
!Chomhain	NP-Fam;
!Chónaill	NP-Fam;
!Chríost	NP-Fam;
!Chrosáin	NP-Fam;
!Chuda	NP-Fam-V;
!Chuda	NP-Fam-V;
!Chúille	NP-Fam;

Ciabhaigh	NP-Fam-chg;
Ciabháin	NP-Fam;
Ciabháin	NP-Fam;
Cianaigh	NP-Fam-chg;
Cianáin	NP-Fam;
Ciaragáin	NP-Fam;
Ciaragáin	NP-Fam;
Ciaráin	NP-Fam;
Ciaráin	NP-Fam;
Ciara	NP-Fam-V;
Ciara	NP-Fam-V;
Ciarasach	NP-Fam-0;
Ciarba	NP-Fam-V;
Ciarmhaic	NP-Fam;
Ciarubháin	NP-Fam;
Cibhil	NP-Fam;
Cibhleacháin	NP-Fam;
Cibhleacháin	NP-Fam;
Cibhlín	NP-Fam;
Ciceam	NP-Fam;
Cilleáin	NP-Fam;
Cillín	NP-Fam;
Cindeargáin	NP-Fam;
Ciniféic	NP-Fam;
Cinnaolaidh	NP-Fam;
Cinndeargáin	NP-Fam;
Cinneáin	NP-Fam;
Cinnéide	NP-Fam;
Cinnicéid	NP-Fam;
Cinnigh	NP-Fam-chg;
Cinsealach	NP-Fam-0;
Cinsealaigh	NP-Fam-chg;
Ciobúin	NP-Fam;
Cíocharáin	NP-Fam;
Cionaoith	NP-Fam;
Cionaoith	NP-Fam;
Cionga	NP-Fam-V;
Ciosáin	NP-Fam;
Cíosáin	NP-Fam;
Cíosáin	NP-Fam;
Cíosóg	NP-Fam;
Cíosóg	NP-Fam;
Ciothrua	NP-Fam-V;
Ciseáin	NP-Fam;
Clabaigh	NP-Fam-chg;
Clamháin	NP-Fam;
Clanndiolún	NP-Fam;
Claonáin	NP-Fam;
Clatháin	NP-Fam;
Cléatún	NP-Fam;
Cléirchín	NP-Fam;
Cléireacháin	NP-Fam;
Cléirigh	NP-Fam-chg;
Cléir	NP-Fam;
Cligeoir	NP-Fam;
Clinse	NP-Fam;
Cliontún	NP-Fam;
Cliseam	NP-Fam;
Cliseam	NP-Fam;
Clochacháin	NP-Fam;
Clochaire	NP-Fam;
Clochaire	NP-Fam;
Clochartaigh	NP-Fam-chg;
Clochasaigh	NP-Fam-chg;
Cluanaigh	NP-Fam-chg;
Cluanaigh	NP-Fam-chg;
Cluanáin	NP-Fam;
Cluasaigh	NP-Fam-chg;
Clúcáin	NP-Fam;
Clúin	NP-Fam;
Clúmháin	NP-Fam;
Clúniháin	NP-Fam;
Cnáimhin	NP-Fam;
Cnáimhín	NP-Fam;
Cnáimh	NP-Fam;
Cnáimhsí	NP-Fam;
Cnáimhsí	NP-Fam;
Cnámhaigh	NP-Fam-chg;
Cnoc	NP-Fam;
Cobhaigh	NP-Fam-chg;
Cochláin	NP-Fam;
Cofaigh	NP-Fam-chg;
Cogaidhín	NP-Fam;
Cogáin	NP-Fam;
Cógan	NP-Fam;
Cogarain	NP-Fam;
Cogaráin	NP-Fam;
Coibheanaigh	NP-Fam-chg;
Coibheanaigh	NP-Fam-chg;
Coifín	NP-Fam;
Coigligh	NP-Fam-chg;
Coigligh	NP-Fam-chg;
Coileáin	NP-Fam;
Coiléir	NP-Fam;
Coilféir	NP-Fam;
Coilín	NP-Fam;
Coilín	NP-Fam;
Coill	NP-Fam;
Coill	NP-Fam;
Coimín	NP-Fam;
Coimín	NP-Fam;
Coineáin	NP-Fam;
Coineoif	NP-Fam;
Coineoil	NP-Fam;
Coineoil	NP-Fam;
Coinín	NP-Fam;
Coinín	NP-Fam;
Coinneacháin	NP-Fam;
Coinneagáin	NP-Fam;
Coinneáin	NP-Fam;
Coinneáin	NP-Fam;
Coinneallaigh	NP-Fam-chg;
Coinne	NP-Fam;
Coinne	NP-Fam;
Coinnigh	NP-Fam-chg;
Coinnill	NP-Fam;
Coinn	NP-Fam;
Coipingéir	NP-Fam;
Cóiplí	NP-Fam;
Coirbhín	NP-Fam;
Coirbín	NP-Fam;
Coirbín	NP-Fam;
Coirc	NP-Fam;
Coirealláin	NP-Fam;
Coirealláin	NP-Fam;
Coirill	NP-Fam;
Coirnín	NP-Fam;
Coise	NP-Fam;
Coise	NP-Fam;
Coisteala	NP-Fam-V;
Coitil	NP-Fam;
Colaim	NP-Fam;
Colbard	NP-Fam;
Colchún	NP-Fam;
Colgan	NP-Fam;
Colla	NP-Fam-V;
Collatáin	NP-Fam;
Collata	NP-Fam-V;
Collchoíll	NP-Fam;
Colltis	NP-Fam;
Collúin	NP-Fam;
Colmáin	NP-Fam;
Colpa	NP-Fam-V;
Coltair	NP-Fam;
Coltil	NP-Fam;
Comada	NP-Fam-V;
Comaín	NP-Fam;
Comáin	NP-Fam;
Comáín	NP-Fam;
Comartún	NP-Fam;
Comhaill	NP-Fam;
Comhain	NP-Fam;
Comhain	NP-Fam;
Comhaln	NP-Fam;
Comhaltáin	NP-Fam;
Comhraí	NP-Fam;
Conaill	NP-Fam;
Conaill	NP-Fam;
Conail	NP-Fam;
Conaing	NP-Fam;
Conaing	NP-Fam;
Conáin	NP-Fam;
Conairce	NP-Fam;
Conaire	NP-Fam;
Conalláin	NP-Fam;
Conallta	NP-Fam-V;
Conallta	NP-Fam-V;
Conámha	NP-Fam-V;
Conanaonaigh	NP-Fam-chg;
Conaola	NP-Fam-V;
Conaola	NP-Fam-V;
Conaonaigh	NP-Fam-chg;
Conaonaigh	NP-Fam-chg;
Conaráin	NP-Fam;
Conbá	NP-Fam;
Conba	NP-Fam-V;
Conbháin	NP-Fam;
Conbhuí	NP-Fam;
Conboirne	NP-Fam;
Concatha	NP-Fam-V;
Concharraige	NP-Fam;
Concharraige	NP-Fam;
Concharridge	NP-Fam;
Concheanainn	NP-Fam;
Conchearca	NP-Fam-V;
Conchoigrí	NP-Fam;
Conchoille	NP-Fam;
Conchoillín	NP-Fam;
Conchollchoille	NP-Fam;
Conchra	NP-Fam-V;
Conchruachan	NP-Fam;
Conchrú	NP-Fam;
Conchúir	NP-Fam;
Conchúir	NP-Fam;
Conduibh	NP-Fam;
Conduibh	NP-Fam;
Condún	NP-Fam;
Conéin	NP-Fam;
Confraoich	NP-Fam;
Congaife	NP-Fam;
Congail	NP-Fam;
Congail	NP-Fam;
Conghaile	NP-Fam;
Conghaile	NP-Fam;
Conghamhna	NP-Fam-V;
Conlachta	NP-Fam-V;
Conléibhe	NP-Fam;
Conleitreach	NP-Fam-0;
Conlocha	NP-Fam-V;
Conluachra	NP-Fam-V;
Conluain	NP-Fam;
Conluaín	NP-Fam;
Conmara	NP-Fam-V;
Conmhaic	NP-Fam;
Conmhaoil	NP-Fam;
Conmidhe	NP-Fam;
Conmidhe	NP-Fam;
!!!!Con Midhe	NP-Fam;
!!!!Con na Búille	NP-Fam;
Connacháin	NP-Fam;
Connachtaigh	NP-Fam-chg;
Connachtáin	NP-Fam;
Connagáin	NP-Fam;
Connaidh	NP-Fam;
Connámha	NP-Fam-V;
Connla	NP-Fam-V;
Connmhacáin	NP-Fam;
Connmhaigh	NP-Fam-chg;
Connuibh	NP-Fam;
Connuibh	NP-Fam;
Conormaoile	NP-Fam;
Conraoi	NP-Fam;
Conratha	NP-Fam-V;
Conriada	NP-Fam-V;
Conriain	NP-Fam;
Conrua	NP-Fam-V;
Conrua	NP-Fam-V;
Consaidín	NP-Fam;
Consnámha	NP-Fam-V;
Contún	NP-Fam;
Conuisce	NP-Fam;
Conuisce	NP-Fam;
Conuladh	NP-Fam;
Conuladh	NP-Fam;
Conurchoille	NP-Fam;
Corbáin	NP-Fam;
Corbhaile	NP-Fam;
Corcáin	NP-Fam;
Corca	NP-Fam-V;
Corcráin	NP-Fam;
Cormacáin	NP-Fam;
Cormaic	NP-Fam;
Corrach	NP-Fam-0;
Corradáin	NP-Fam;
Corragáin	NP-Fam;
Corraín	NP-Fam;
Corraín	NP-Fam;
Corráin	NP-Fam;
Corráin	NP-Fam;
Corra	NP-Fam-V;
Corra	NP-Fam-V;
Corrbuí	NP-Fam;
Corrdubh	NP-Fam;
Corrduibh	NP-Fam;
Corsain	NP-Fam;
Corscadán	NP-Fam;
Corthaid	NP-Fam;
Cosáin	NP-Fam;
Coscracháin	NP-Fam;
Coscraigh	NP-Fam-chg;
Cosnacháin	NP-Fam;
Costún	NP-Fam;
Cothaigh	NP-Fam-chg;
Cotún	NP-Fam;
Crábhagáin	NP-Fam;
Crábháin	NP-Fam;
Cradóc	NP-Fam;
Cráfaigh	NP-Fam-chg;
Cráibhín	NP-Fam;
Craith	NP-Fam;
Craith	NP-Fam;
Craobhach	NP-Fam-0;
Craoirinn	NP-Fam;
Créacháin	NP-Fam;
Creacht	NP-Fam;
Creag	NP-Fam;
Criagáin	NP-Fam;
Criocháin	NP-Fam;
Críocháin	NP-Fam;
Críocháln	NP-Fam;
Críodáin	NP-Fam;
Criomhthainn	NP-Fam;
Crionagáin	NP-Fam;
Crionáin	NP-Fam;
Críonáin	NP-Fam;
Criostail	NP-Fam;
Críosta	NP-Fam-V;
Críostóir	NP-Fam;
Críostóra	NP-Fam-V;
Cristin	NP-Fam;
Cristín	NP-Fam;
Crócar	NP-Fam;
Crochtas	NP-Fam;
Crochtún	NP-Fam;
Cróc	NP-Fam;
Croidheagáin	NP-Fam;
Croidheáin	NP-Fam;
Croimín	NP-Fam;
Croim	NP-Fam;
Croim	NP-Fam;
Cróinín	NP-Fam;
Cróin	NP-Fam;
Cromail	NP-Fam;
Cromlaoich	NP-Fam;
Cromroisc	NP-Fam;
Cromtha	NP-Fam-V;
Crónagáin	NP-Fam;
Crónaile	NP-Fam;
Crónáin	NP-Fam;
Crotaigh	NP-Fam-chg;
Crothair	NP-Fam;
Crualaoich	NP-Fam;
Cruimein	NP-Fam;
Crúiséir	NP-Fam;
Crúis	NP-Fam;
Cuacháin	NP-Fam;
Cuagáin	NP-Fam;
Cuag	NP-Fam;
Cuag	NP-Fam;
Cuaig	NP-Fam;
Cuaig	NP-Fam;
Cuairt	NP-Fam;
Cuanacháin	NP-Fam;
Cuanáin	NP-Fam;
Cuana	NP-Fam-V;
Cuanartaigh	NP-Fam-chg;
Cuarnacháin	NP-Fam;
Cuarta	NP-Fam-V;
Cubhráin	NP-Fam;
Cúibhréith	NP-Fam;
Cúibreith	NP-Fam;
Cúibreith	NP-Fam;
Cuidithe	NP-Fam;
Cuidithe	NP-Fam;
Cuileagáin	NP-Fam;
Cuileagáin	NP-Fam;
Cuileandar	NP-Fam;
Cuileannáin	NP-Fam;
Cuileannáin	NP-Fam;
Cuileannáín	NP-Fam;
Cuilinn	NP-Fam;
Cuilinn	NP-Fam;
Cúilinn	NP-Fam;
Cuilín	NP-Fam;
Cuiliuin	NP-Fam;
Cuiliúin	NP-Fam;
Cúille	NP-Fam;
Cuiltéir	NP-Fam;
Cuimín	NP-Fam;
Cuimín	NP-Fam;
Cuindlis	NP-Fam;
Cuineáin	NP-Fam;
Cuineáin	NP-Fam;
Cuineog	NP-Fam;
Cuinlis	NP-Fam;
Cuinlis	NP-Fam;
Cuinneagáin	NP-Fam;
Cuinneáin	NP-Fam;
Cúipéir	NP-Fam;
Cuirín	NP-Fam;
Cuirnín	NP-Fam;
Cuirtéis	NP-Fam;
Cuirtín	NP-Fam;
Cúisín	NP-Fam;
Culacháin	NP-Fam;
Cúlacháin	NP-Fam;
Cumaráin	NP-Fam;
Cumascaigh	NP-Fam-chg;
Cumhaill	NP-Fam;
Cumhaí	NP-Fam;
Curnáin	NP-Fam;
Cúrsa	NP-Fam;
Curtáin	NP-Fam;
Cút	NP-Fam;
!!!Cú Uladh	NP-Fam;
Dabhóg	NP-Fam;
Dábhoireann	NP-Fam;
Daghnáin	NP-Fam;
Daibhéid	NP-Fam;
Dáibhí	NP-Fam;
Dáibhis	NP-Fam;
Daighre	NP-Fam;
Dailbhre	NP-Fam;
Dailgheal	NP-Fam;
Daill	NP-Fam;
Daimhín	NP-Fam;
Dáinséir	NP-Fam;
Dairbhre	NP-Fam;
Dairdis	NP-Fam;
Dáire	NP-Fam;
Dalachair	NP-Fam;
Dálaigh	NP-Fam-chg;
Dalaithíd	NP-Fam;
Dalamara	NP-Fam-V;
Dalarua	NP-Fam-V;
Dallacháin	NP-Fam;
Dallachair	NP-Fam;
Dalláin	NP-Fam;
Daltúin	NP-Fam;
Damháin	NP-Fam;
Danachair	NP-Fam;
Darach	NP-Fam-0;
Darach	NP-Fam-0;
Dara	NP-Fam-V;
Dasaí	NP-Fam;
Dásan	NP-Fam;
Dathail	NP-Fam;
Dathlaoich	NP-Fam;
Dátún	NP-Fam;
Déabhrús	NP-Fam;
Deacair	NP-Fam;
Deacair	NP-Fam;
Déadaigh	NP-Fam-chg;
Deafaigh	NP-Fam-chg;
Deagánaigh	NP-Fam-chg;
Déanaigh	NP-Fam-chg;
Deá	NP-Fam;
Dearáin	NP-Fam;
Deargáin	NP-Fam;
Deasúnaigh	NP-Fam-chg;
Deibhinis	NP-Fam;
Déin	NP-Fam;
Deirg	NP-Fam;
Déiseach	NP-Fam-0;
Déise	NP-Fam;
Déisigh	NP-Fam-chg;
Deisil	NP-Fam;
Denn	NP-Fam;
!!!Dé	NP-Fam;
!!!Dé	NP-Fam;
Denvir	NP-Fam;
Deocáin	NP-Fam;
Deoir	NP-Fam;
Deoraidh	NP-Fam;
Deoráin	NP-Fam;

Dabhaic	NP-Fam;
Dabhóc	NP-Fam;
Dabhóg	NP-Fam;
Daibhéid	NP-Fam;
Daibhéid	NP-Fam;
Dáibhidh	NP-Fam;
Dáibhí	NP-Fam;
Dalbhéid	NP-Fam;
Diarmada	NP-Fam-V;
Díomasaigh	NP-Fam-chg;
Díomasaigh	NP-Fam-chg;
Doinneabháin	NP-Fam;
Doinnéibhe	NP-Fam;
Doinnféibhín	NP-Fam;
Doinnléibhe	NP-Fam;
Doinnléibhe	NP-Fam;
Doinnléibhín	NP-Fam;
Doinn	NP-Fam;
Doinn	NP-Fam;
Doinn	NP-Fam;
Dónaill	NP-Fam;
Dónaill	NP-Fam;
Donnagáin	NP-Fam;
Donnchaidh	NP-Fam;
Donnchaidh	NP-Fam;
Donncha	NP-Fam-V;
Dorchaidh	NP-Fam;
Dorchaidh	NP-Fam;
Dorcha	NP-Fam-V;
Duáin	NP-Fam;
Duarcáin	NP-Fam;
Duarcáin	NP-Fam;
Dubhaigh	NP-Fam-chg;
Dúghaill	NP-Fam;
Duibhín	NP-Fam;
Dibhín	NP-Fam;
Duíbhín	NP-Fam;
Duibhinse	NP-Fam;
Duibhinse	NP-Fam;
Duibhne	NP-Fam;
Duíbhne	NP-Fam;
Duibh	NP-Fam;
Duibh	NP-Fam;
Duifinn	NP-Fam;
Duifinn	NP-Fam;
Duifithe	NP-Fam;
Duifíthe	NP-Fam;
Duifíthe	NP-Fam;
Dineachair	NP-Fam;
Duinneabháin	NP-Fam;


!!Dhabhaic	NP-Fam;
!Dhabhóc	NP-Fam;
!Dhabhóg	NP-Fam;
!Dhaibhéid	NP-Fam;
!Dhaibhéid	NP-Fam;
!Dháibhidh	NP-Fam;
!Dháibhí	NP-Fam;
!Dhalbhéid	NP-Fam;
!Dhiarmada	NP-Fam-V;
!Dhíomasaigh	NP-Fam-chg;
!Dhíomasaigh	NP-Fam-chg;
!Dhoinneabháin	NP-Fam;
!Dhoinnéibhe	NP-Fam;
!Dhoinnféibhín	NP-Fam;
!Dhoinnléibhe	NP-Fam;
!Dhoinnléibhe	NP-Fam;
!Dhoinnléibhín	NP-Fam;
!Dhoinn	NP-Fam;
!Dhoinn	NP-Fam;
!Dhoinn	NP-Fam;
!Dhónaill	NP-Fam;
!Dhónaill	NP-Fam;
!Dhonnagáin	NP-Fam;
!Dhonnchaidh	NP-Fam;
!Dhonnchaidh	NP-Fam;
!Dhonncha	NP-Fam-V;
!Dhorchaidh	NP-Fam;
!Dhorchaidh	NP-Fam;
!Dhorcha	NP-Fam-V;
!Dhuáin	NP-Fam;
!Dhuarcáin	NP-Fam;
!Dhuarcáin	NP-Fam;
!Dhubhaigh	NP-Fam-chg;
!Dhúghaill	NP-Fam;
!Dhuibhín	NP-Fam;
!Dhuibhín	NP-Fam;
!Dhuíbhín	NP-Fam;
!Dhuibhinse	NP-Fam;
!Dhuibhinse	NP-Fam;
!Dhuibhne	NP-Fam;
!Dhuíbhne	NP-Fam;
!Dhuibh	NP-Fam;
!Dhuibh	NP-Fam;
!Dhuifinn	NP-Fam;
!Dhuifinn	NP-Fam;
!Dhuifithe	NP-Fam;
!Dhuifíthe	NP-Fam;
!Dhuifíthe	NP-Fam;
!Dhuineachair	NP-Fam;
!Dhuinneabháin	NP-Fam;
Diaghaidh	NP-Fam;
!!Diarmada Gall	NP-Fam;
Diarmada	NP-Fam;
!!Diarmada Rua	NP-Fam-V;
Diochon	NP-Fam;
Díochon	NP-Fam;
Diolún	NP-Fam;
Díomáin	NP-Fam;
Díomasaigh	NP-Fam-chg;
Díorma	NP-Fam-V;
Díring	NP-Fam;
Dirín	NP-Fam;
Díscín	NP-Fam;
Disní	NP-Fam;
Dob	NP-Fam;
Dochartaigh	NP-Fam-chg;
Dochraigh	NP-Fam-chg;
Doda	NP-Fam-V;
Doghair	NP-Fam;
Doibhilin	NP-Fam;
Doibín	NP-Fam;
Doidín	NP-Fam;
Doilfín	NP-Fam;
Doineannaigh	NP-Fam;
Doineannaigh	NP-Fam-chg;
Doinnchinn	NP-Fam;
Doinneabháin	NP-Fam;
Doinneacháin	NP-Fam;
Doinneagáin	NP-Fam;
Doinneard	NP-Fam;
Doinnléibhe	NP-Fam;
Doinnlé	NP-Fam;
Doinn	NP-Fam;
Doirbheáin	NP-Fam;
Doirbhín	NP-Fam;
Doirinne	NP-Fam;
Doirí	NP-Fam;
Doirnín	NP-Fam;
Dollard	NP-Fam;
Domagáin	NP-Fam;
domhnaigh	NP-Fam-chg;
Donagáin	NP-Fam;
Dónaill	NP-Fam;
Dónalláin	NP-Fam;
Dondún	NP-Fam;
Donnabháin	NP-Fam;
Donnacháin	NP-Fam;
Donnagáin	NP-Fam;
Donnaile	NP-Fam;
Donnáin	NP-Fam;
Donnasa	NP-Fam-V;
Donnchaidh	NP-Fam;
Donncha	NP-Fam-V;
Donnchathaigh	NP-Fam-chg;
Donnchú	NP-Fam;
Donnuartaigh	NP-Fam-chg;
Donnúir	NP-Fam;
Doraidh	NP-Fam;
Dorcháin	NP-Fam;
Dorchaí	NP-Fam;
Dorcha	NP-Fam-V;
Dorcha	NP-Fam-V;
Dornáin	NP-Fam;
Drach	NP-Fam-0;
Draighneáin	NP-Fam;
Draighneáin	NP-Fam;
Draoda	NP-Fam-V;
Draoileáin	NP-Fam;
Draoi	NP-Fam;
Draopar	NP-Fam;
Dreada	NP-Fam-V;
Dreáin	NP-Fam;
Drisceoil	NP-Fam;
Drisleáin	NP-Fam;
Drochtaigh	NP-Fam-chg;
Drogh	NP-Fam;
Droichid	NP-Fam;
Droimín	NP-Fam;
Dromáin	NP-Fam;
Droma	NP-Fam-V;
Dromgúl	NP-Fam;
Dróna	NP-Fam-V;
Druacháin	NP-Fam;
Druagáin	NP-Fam;
Druaidh	NP-Fam;
Drugáin	NP-Fam;
Druifín	NP-Fam;
Duacháin	NP-Fam;
Duagáin	NP-Fam;
Duáin	NP-Fam;
Duáin	NP-Fam;
Dúain	NP-Fam;
Duánaigh	NP-Fam-chg;
Duartaigh	NP-Fam-chg;
Dubhaigh	NP-Fam-chg;
Dubhaigh	NP-Fam-chg;
Dubháin	NP-Fam;
Dubhánaigh	NP-Fam-chg;
Dubhasa	NP-Fam-V;
Dubhuí	NP-Fam;
Dubhuir	NP-Fam;
Dubhuír	NP-Fam;
Dúchair	NP-Fam;
Dúchonna	NP-Fam-V;
Dúchon	NP-Fam;
Dúdacáin	NP-Fam;
Dúdacháin	NP-Fam;
Dúdáleithe	NP-Fam;
Dúdal	NP-Fam;
Dúda	NP-Fam-V;
Dúdhíorma	NP-Fam-V;
Dufaigh	NP-Fam-chg;
Dúghaill	NP-Fam;
Dúghaill	NP-Fam;
Dúghlais	NP-Fam;
Duibheanaigh	NP-Fam-chg;
Duibheannaigh	NP-Fam-chg;
Duibhín	NP-Fam;
Duíbhí	NP-Fam;
Duibhiolla	NP-Fam-V;
Duibhir	NP-Fam;
Duibhír	NP-Fam;
Duibhne	NP-Fam;
Duibh	NP-Fam;
Duícinn	NP-Fam;
Duidhíorma	NP-Fam-V;
Duídhíorma	NP-Fam-V;
Duifinn	NP-Fam;
Duifiolla	NP-Fam-V;
Duifleáin	NP-Fam;
Duiflín	NP-Fam;
Duigeadáin	NP-Fam;
Duígeadáin	NP-Fam;
Duigeannáin	NP-Fam;
Duígeannáin	NP-Fam;
Duighiolla	NP-Fam-V;
Duíginn	NP-Fam;
Duíleacháin	NP-Fam;
Duílearga	NP-Fam-V;
Duílearga	NP-Fam-V;
Duilé	NP-Fam;
Duineacháin	NP-Fam;
Duineachair	NP-Fam;
Duineacha	NP-Fam-V;
!!!duine	NP-Fam;
Duíne	NP-Fam;
Dúinín	NP-Fam;
Duinnin	NP-Fam;
Duinnín	NP-Fam;
Duinnreachtaigh	NP-Fam-chg;
Dúinsméarach	NP-Fam-0;
Duirnín	NP-Fam;
Duir	NP-Fam;
Dúlacháin	NP-Fam;
Dúlachta	NP-Fam-V;
Dúladaigh	NP-Fam-chg;
Dúláinne	NP-Fam;
Dúláinne	NP-Fam;
Dúlainn	NP-Fam;
Dúláin	NP-Fam;
Dúlaoich	NP-Fam;
Dulchaointigh	NP-Fam-chg;
Dúllaing	NP-Fam;
Dúluachra	NP-Fam-V;
Dúnabhra	NP-Fam-V;
Dunacháin	NP-Fam;
Dúnacháin	NP-Fam;
Dúnagáin	NP-Fam;
Dúnaigh	NP-Fam-chg;
Dúnáin	NP-Fam;
Dúna	NP-Fam-V;
Dúradáin	NP-Fam;
Dúraic	NP-Fam;
Dúrais	NP-Fam;
Duram	NP-Fam;
Dúrasa	NP-Fam-V;
Dúrthuile	NP-Fam;
Dúthaigh	NP-Fam-chg;
Éabhróid	NP-Fam;
Eachach	NP-Fam-0;
Eachagáin	NP-Fam;
Eachaidh	NP-Fam;
Eachaidh	NP-Fam;
Eachaídh	NP-Fam;
Eachaigh	NP-Fam-chg;
Eachaín	NP-Fam;
Eacháin	NP-Fam;
Eacháin	NP-Fam;
Eacháin	NP-Fam;
Eacharna	NP-Fam-V;
Eachartaigh	NP-Fam-chg;
Eachmhile	NP-Fam;
Eachmhíle	NP-Fam;
Eachráin	NP-Fam;
Eachráin	NP-Fam;
Eachtair	NP-Fam;
Eachuáin	NP-Fam;
Eachuáin	NP-Fam;
Eachú	NP-Fam;
Eadamháin	NP-Fam;
Éadbhaird	NP-Fam;
Eadromáin	NP-Fam;
Éafaígh	NP-Fam;
Eafarcaigh	NP-Fam-chg;
Eafartaigh	NP-Fam-chg;
Eaglais	Nf2-Prop;
Eáin	NP-Fam;
Eáin	NP-Fam;
Éamainn	NP-Fam;
Éanacháin	NP-Fam;
Éanadáin	NP-Fam;
Eanchaí	NP-Fam;
Eanna	NP-Fam-V;
Éanna	NP-Fam-V;
Éanna	NP-Fam-V;
Eanraic	NP-Fam;
Eanraic	NP-Fam;
Éanú	NP-Fam;
Earaile	NP-Fam;
Earaíle	NP-Fam;
Earail	NP-Fam;
Earail	NP-Fam;
Earaíl	NP-Fam;
Earáin	NP-Fam;
Earáin	NP-Fam;
Eáráin	NP-Fam;
Eára	NP-Fam-V;
Eararáin	NP-Fam;
Earcáin	NP-Fam;
Earca	NP-Fam-V;
Earchaidh	NP-Fam;
Earchaí	NP-Fam;
Earchaír	NP-Fam;
Earga	NP-Fam-V;
Earnáin	NP-Fam;
Earnáin	NP-Fam;
Earna	NP-Fam-V;
Earna	NP-Fam-V;
Easmann	NP-Fam;
Easpaig	NP-Fam;
Easpaig	NP-Fam;
Eathach	NP-Fam-0;
Eathírn	NP-Fam;
Eathírn	NP-Fam;
Éatún	NP-Fam;
Eibhearard	NP-Fam;
Eichingeam	NP-Fam;
Eideagáin	NP-Fam;
Eídeáin	NP-Fam;
Eidhin	NP-Fam;
Eídhín	NP-Fam;
Eidhneáin	NP-Fam;
Eidich	NP-Fam;
Éidigh	NP-Fam-chg;
Éidín	NP-Fam;
Éigear	NP-Fam;
Eigeartaigh	NP-Fam-chg;
Éigeartaigh	NP-Fam-chg;
Éignígh	NP-Fam;
Éignigh	NP-Fam-chg;
Eileasáin	NP-Fam;
Éilí	NP-Fam;
Éílí	NP-Fam;
Éílíthe	NP-Fam;
Eiméid	NP-Fam;
Eimheacháin	NP-Fam;
Éimheacháin	NP-Fam;
Éímheacháin	NP-Fam;
Éimhigh	NP-Fam-chg;
Éímhigh	NP-Fam-chg;
Eímhín	NP-Fam;
Éimhín	NP-Fam;
Éimhir	NP-Fam;
Éimhrín	NP-Fam;
Éineacháin	NP-Fam;
Éinrí	NP-Fam;
Éinrí	NP-Fam;
Eirc	NP-Fam;
Eirc	NP-Fam;
Eireamhóin	NP-Fam;
Eireamhóin	NP-Fam;
Eislin	NP-Fam;
Eiteagáin	NP-Fam;
Eithírn	NP-Fam;
Eitigh	NP-Fam-chg;
Eitigh	NP-Fam-chg;
Eochach	NP-Fam-0;
Eochagáin	NP-Fam;
Eochagáin	NP-Fam;
Eochaidh	NP-Fam;
Eochaidh	NP-Fam;
Eochaín	NP-Fam;
Eocháin	NP-Fam;
Eoghain	NP-Fam;
Eoghain	NP-Fam;
Eoghanáin	NP-Fam;
Eoin	NP-Fam;
Eoin	NP-Fam;
Eoín	NP-Fam;
Eolasa	NP-Fam-V;
Eosa	NP-Fam-V;
Eothach	NP-Fam-0;
Fachtnáin	NP-Fam;
Fachtna	NP-Fam-V;
Fágán	NP-Fam;
Faghan	NP-Fam;
Faghartaigh	NP-Fam-chg;
Fáilbhe	NP-Fam;
Fainín	NP-Fam;
Faircheallaigh	NP-Fam-chg;
Fairsing	NP-Fam;
Fallúin	NP-Fam;
Fant	NP-Fam;
Faogáin	NP-Fam;
Faoileacháin	NP-Fam;
Faoileáin	NP-Fam;
Faoite	NP-Fam;
Faoitigh	NP-Fam-chg;
Faoláin	NP-Fam;
Faoláin	NP-Fam;
Faolchaidh	NP-Fam;
Faolchair	NP-Fam;
Farannáin	NP-Fam;
Farcháin	NP-Fam;
Farraigh	NP-Fam-chg;
Fathaigh	NP-Fam-chg;
Fathaigh	NP-Fam-chg;
Fathartaigh	NP-Fam-chg;
Feadagáin	NP-Fam;
Fearaigh	NP-Fam-chg;
Fearaigh	NP-Fam-chg;
Fearail	NP-Fam;
Fearáin	NP-Fam;
Fearais	NP-Fam;
Fearais	NP-Fam;
Fearasa	NP-Fam-V;
Fearchaí	NP-Fam;
Fearchair	NP-Fam;
Fearghail	NP-Fam;
Fearghais	NP-Fam;
Fearghais	NP-Fam;
Fearghasa	NP-Fam-V;
Fearsíthe	NP-Fam;
Féichín	NP-Fam;
Féich	NP-Fam;
Feidhlimidh	NP-Fam;
Feidhlim	NP-Fam;
Feilimí	NP-Fam;
Feirtéir	NP-Fam;
Feoirling	NP-Fam;

Fachtna	NP-Fam-V;
Fachtna	NP-Fam-V;
Faifí	NP-Fam;
Failigh	NP-Fam-chg;
Failigh	NP-Fam-chg;
Failí	NP-Fam;
Failí	NP-Fam;
Faoláin	NP-Fam;
Faoláin	NP-Fam;
Fearaígh	NP-Fam;
Fearaigh	NP-Fam-chg;
Fearaigh	NP-Fam-chg;
Fearaile	NP-Fam;
Fearail	NP-Fam;
Fearail	NP-Fam;
Fearaíl	NP-Fam;
Fearaíl	NP-Fam;
Fearchail	NP-Fam;
Fearchair	NP-Fam;
Fearchair	NP-Fam;
Feargail	NP-Fam;
Feargall	NP-Fam;
Fearga	NP-Fam-V;
Fearghail	NP-Fam;
Fearghasa	NP-Fam-V;
Feorais	NP-Fam;
Feorais	NP-Fam;
Fiachra	NP-Fam-V;
Fiarais	NP-Fam;
Fibín	NP-Fam;
Fibín	NP-Fam;
File	NP-Fam;
File	NP-Fam;
Filib	NP-Fam;
Fílíb	NP-Fam;
Finín	NP-Fam;
Fínneachtaigh	NP-Fam-chg;
Finneachta	NP-Fam-V;
Finneachta	NP-Fam-V;
Finnéin	NP-Fam;
Finnéin	NP-Fam;
Fínnéín	NP-Fam;
Finn	NP-Fam;
Finn	NP-Fam;
Fíobhuí	NP-Fam;
Fíobhuí	NP-Fam;
Fíodair	NP-Fam;
Fiondáin	NP-Fam;
Fiondáin	NP-Fam;
Fionda	NP-Fam-V;
Fionnachta	NP-Fam-V;
Fionnaíle	NP-Fam;
Fionnail	NP-Fam;
Fionnáin	NP-Fam;
Fionnáin	NP-Fam;
Fionnbhairr	NP-Fam;
Fionnbhairr	NP-Fam;
Fionnlaoich	NP-Fam;
Fionnmhacáin	NP-Fam;
Fionntáin	NP-Fam;
Fiontáin	NP-Fam;
Firléinn	NP-Fam;
Firléinn	NP-Fam;
Fírléinn	NP-Fam;
Fir	NP-Fam;
Flainn	NP-Fam;
Fleastair	NP-Fam;
Floinn	NP-Fam;
Floinn	NP-Fam;
Fógartaigh	NP-Fam-chg;
Frainc	NP-Fam;
Francaigh	NP-Fam-chg;
Fualáin	NP-Fam;


!Fhachtna	NP-Fam-V;
!Fhachtna	NP-Fam-V;
!Fhaifí	NP-Fam;
!Fhailigh	NP-Fam-chg;
!Fhailigh	NP-Fam-chg;
!Fhailí	NP-Fam;
!Fhailí	NP-Fam;
!Fhaoláin	NP-Fam;
!Fhaoláin	NP-Fam;
!Fhearaígh	NP-Fam;
!Fhearaigh	NP-Fam-chg;
!Fhearaigh	NP-Fam-chg;
!Fhearaile	NP-Fam;
!Fhearail	NP-Fam;
!Fhearail	NP-Fam;
!Fhearaíl	NP-Fam;
!Fhearaíl	NP-Fam;
!Fhearchail	NP-Fam;
!Fhearchair	NP-Fam;
!Fhearchair	NP-Fam;
!Fheargail	NP-Fam;
!Fheargall	NP-Fam;
!Fhearga	NP-Fam-V;
!Fhearghail	NP-Fam;
!Fhearghasa	NP-Fam-V;
!Fheorais	NP-Fam;
!Fheorais	NP-Fam;
!Fhiachra	NP-Fam-V;
!Fhiarais	NP-Fam;
!Fhibín	NP-Fam;
!Fhibín	NP-Fam;
!Fhile	NP-Fam;
!Fhile	NP-Fam;
!Fhilib	NP-Fam;
!Fhílíb	NP-Fam;
!Fhinín	NP-Fam;
!Fhínneachtaigh	NP-Fam-chg;
!Fhinneachta	NP-Fam-V;
!Fhinneachta	NP-Fam-V;
!Fhinnéin	NP-Fam;
!Fhinnéin	NP-Fam;
!Fhínnéín	NP-Fam;
!Fhinn	NP-Fam;
!Fhinn	NP-Fam;
!Fhíobhuí	NP-Fam;
!Fhíobhuí	NP-Fam;
!Fhíodair	NP-Fam;
!Fhiondáin	NP-Fam;
!Fhiondáin	NP-Fam;
!Fhionda	NP-Fam-V;
!Fhionnachta	NP-Fam-V;
!Fhionnaíle	NP-Fam;
!Fhionnail	NP-Fam;
!Fhionnáin	NP-Fam;
!Fhionnáin	NP-Fam;
!Fhionnbhairr	NP-Fam;
!Fhionnbhairr	NP-Fam;
!Fhionnlaoich	NP-Fam;
!Fhionnmhacáin	NP-Fam;
!Fhionntáin	NP-Fam;
!Fhiontáin	NP-Fam;
!Fhirléinn	NP-Fam;
!Fhirléinn	NP-Fam;
!Fhírléinn	NP-Fam;
!Fhir	NP-Fam;
!Fhlainn	NP-Fam;
!Fhleastair	NP-Fam;
!Fhloinn	NP-Fam;
!Fhloinn	NP-Fam;
!Fhógartaigh	NP-Fam-chg;
!Fhrainc	NP-Fam;
!Fhrancaigh	NP-Fam-chg;
!Fhualáin	NP-Fam;


Fiacháin	NP-Fam;
Fiacha	NP-Fam-V;
Fiacha	NP-Fam-V;
Fiachna	NP-Fam-V;
Fiachra	NP-Fam-V;
Fiachra	NP-Fam-V;
Fiaich	NP-Fam;
Fiaich	NP-Fam;
Fialáin	NP-Fam;
Fiannachta	NP-Fam-V;
Fiannaí	NP-Fam;
Ficheallaigh	NP-Fam-chg;
Fichill	NP-Fam;
Finín	NP-Fam;
Finn	NP-Fam;
Finnthírn	NP-Fam;
Fíobhair	NP-Fam;
Fíobhra	NP-Fam-V;
Fionamúr	NP-Fam;
Fiongardail	NP-Fam;
Fionmhacáin	NP-Fam;
Fionnachtaigh	NP-Fam-chg;
Fionnachta	NP-Fam-V;
Fionnagáin	NP-Fam;
Fionnail	NP-Fam;
Fionnáin	NP-Fam;
Fionnalaigh	NP-Fam-chg;
Fionnaláin	NP-Fam;
Fionnalláin	NP-Fam;
Fionnasa	NP-Fam-V;
Fionnghlas	NP-Fam;
Fionúir	NP-Fam;
Fiotún	NP-Fam;
Firbhisigh	NP-Fam-chg;
Flaibheartaigh	NP-Fam-chg;
Flainn	NP-Fam;
Flaitheamháin	NP-Fam;
Flaitheartaigh	NP-Fam-chg;
Flaithimhín	NP-Fam;
Flaithimh	NP-Fam;
Flaitile	NP-Fam;
Flaitire	NP-Fam;
Flanagáin	NP-Fam;
Flannabhra	NP-Fam-V;
Flannacháin	NP-Fam;
Flannagáin	NP-Fam;
Flannaile	NP-Fam;
Flannail	NP-Fam;
Flathaigh	NP-Fam-chg;
Flint	NP-Fam;
Floinn	NP-Fam;
Fógartaigh	NP-Fam-chg;
Foghartaigh	NP-Fam-chg;
Foghlú	NP-Fam;
Foirbhithe	NP-Fam;
Foiréis	NP-Fam;
Foirréidh	NP-Fam;
Foirtcheirn	NP-Fam;
Fóiséid	NP-Fam;
Follúin	NP-Fam;
Frainclín	NP-Fam;
Freaghaile	NP-Fam;
Freathail	NP-Fam;
Fréine	NP-Fam;
Fréin	NP-Fam;
Fríle	NP-Fam;
Fríl	NP-Fam;
Frinse	NP-Fam;
Friseal	NP-Fam;
Frithile	NP-Fam;
Frithil	NP-Fam;
Friúin	NP-Fam;
Fuadacháin	NP-Fam;
Fuada	NP-Fam-V;
Fuada	NP-Fam-V;
Fuallaigh	NP-Fam-chg;
Fuaráin	NP-Fam;
Fuartháin	NP-Fam;
Fuaruisce	NP-Fam;
Fuathaigh	NP-Fam-chg;
Fúinse	NP-Fam;
Fuireastal	NP-Fam;
Fuiréast	NP-Fam;
Fuite	NP-Fam;
Fuitléigh	NP-Fam-chg;
Fuitnigh	NP-Fam-chg;
Furlong	NP-Fam;
Futrail	NP-Fam;
Gábháin	NP-Fam;
Gabhalaigh	NP-Fam-chg;
Gabhann	NP-Fam;
Gabhann	NP-Fam;
Gabha	NP-Fam-V;
Gabhláin	NP-Fam;
Gabhláin	NP-Fam;
Gabhla	NP-Fam-V;
Gabhla	NP-Fam-V;
Gabhráin	NP-Fam;
Gabóid	NP-Fam;
Gacháin	NP-Fam;
Gadhra	NP-Fam-V;
Gadhra	NP-Fam-V;
Gafraidh	NP-Fam;
Gaibheacháin	NP-Fam;
Gaibhidh	NP-Fam;
Gáibhín	NP-Fam;
Gáifeacháin	NP-Fam;
Gailineach	NP-Fam-0;
Gaillín	NP-Fam;
Gaillí	NP-Fam;
Gaimlín	NP-Fam;
Gáin	NP-Fam;
Gairbheith	NP-Fam;
Gairbhín	NP-Fam;
Gairbhith	NP-Fam;
Gairnéir	NP-Fam;
Gaisteal	NP-Fam;
Galáin	NP-Fam;
Gallbhaile	NP-Fam;
Gallchóir	NP-Fam;
Gallchú	NP-Fam;
Gallda	NP-Fam-V;
Gamal	NP-Fam;
Gambún	NP-Fam;
Gamhnáin	NP-Fam;
Gamhnaire	NP-Fam;
Gamhna	NP-Fam-V;
Gánaird	NP-Fam;
Gaoithe	NP-Fam;
Gaoithín	NP-Fam;
Gaoithín	NP-Fam;
Gaor	NP-Fam;
Gaor	NP-Fam;
Gaor	NP-Fam;
Garacháin	NP-Fam;
Garbháin	NP-Fam;
Garmaile	NP-Fam;
Garmaile	NP-Fam;
Gascún	NP-Fam;
Gastún	NP-Fam;
Gatlaoich	NP-Fam;
Gatlaoich	NP-Fam;
Gealagáin	NP-Fam;
Gealáin	NP-Fam;
Gealbháin	NP-Fam;
Gearaga	NP-Fam-V;
Gearailt	NP-Fam;
Géaráin	NP-Fam;
Géaráin	NP-Fam;
Gearard	NP-Fam;
Gearbhás	NP-Fam;
Gearbhás	NP-Fam;
Geard	NP-Fam;
Geargáin	NP-Fam;
Gearlann	NP-Fam;
Gearmann	NP-Fam;
Gearmann	NP-Fam;
Gearmán	NP-Fam;
Gearmán	NP-Fam;
Gearnún	NP-Fam;
Gearóid	NP-Fam;
Gearóid	NP-Fam;
Gearrthóir	NP-Fam;
Géibheannaigh	NP-Fam-chg;
Géibheannaigh	NP-Fam-chg;
Géibhinn	NP-Fam;
Geirble	NP-Fam;

Gaill	NP-Fam;
Gaill	NP-Fam;
Gairbh	NP-Fam;
Gallóghlaigh	NP-Fam-chg;
Gallóglaigh	NP-Fam-chg;
Gallóglaigh	NP-Fam-chg;
Gannáin	NP-Fam;
Geairr	NP-Fam;
Geairr	NP-Fam;
Gearr	NP-Fam;
Gearr	NP-Fam;
Geata	NP-Fam;
Geata	NP-Fam-V;
Geimhridh	NP-Fam;
Geimhridh	NP-Fam;
Géir	NP-Fam;
Girr	NP-Fam;
Glais	NP-Fam;
Gleanna	NP-Fam-V;
Gleanntáín	NP-Fam;
Goill	NP-Fam;
Goill	NP-Fam;
Goirm	NP-Fam;
Grinn	NP-Fam;
Guala	NP-Fam-V;
Guala	NP-Fam-V;
Guda	NP-Fam-V;
Gunna	NP-Fam-V;
Gunna	NP-Fam-V;

!Ghaill	NP-Fam;
!Ghaill	NP-Fam;
!Ghairbh	NP-Fam;
!Ghallóghlaigh	NP-Fam-chg;
!Ghallóglaigh	NP-Fam-chg;
!Ghallóglaigh	NP-Fam-chg;
!Ghannáin	NP-Fam;
!Gheairr	NP-Fam;
!Gheairr	NP-Fam;
!Ghearr	NP-Fam;
!Ghearr	NP-Fam;
!Gheata	NP-Fam;
!Gheata	NP-Fam-V;
!Gheimhridh	NP-Fam;
!Gheimhridh	NP-Fam;
!Ghéir	NP-Fam;
!Ghirr	NP-Fam;
!Ghlais	NP-Fam;
!Ghleanna	NP-Fam-V;
!Ghleanntáín	NP-Fam;
!Ghoill	NP-Fam;
!Ghoill	NP-Fam;
!Ghoirm	NP-Fam;
!Ghrinn	NP-Fam;
!Ghuala	NP-Fam-V;
!Ghuala	NP-Fam-V;
!Ghuda	NP-Fam-V;
!Ghunna	NP-Fam-V;
!Ghunna	NP-Fam-V;


Gialláin	NP-Fam;
Gibealláin	NP-Fam;
Gibne	NP-Fam;
Gib	NP-Fam;
Gilbeirt	NP-Fam;
Gileáin	NP-Fam;
Gilín	NP-Fam;
Gilleáin	NP-Fam;
Gilleán	NP-Fam;
Gillín	NP-Fam;
Gineáith	NP-Fam;
Giobúin	NP-Fam;
Giobúin	NP-Fam;
Giodaire	NP-Fam;
!!!Giolla Bhuí	NP-Fam;
!!!Giolla Domhnaigh	NP-Fam-chg;
Giollagáin	NP-Fam;
Giolláin	NP-Fam;
!!Gíolla Íosa	NP-Fam-V;
Giolla	NP-Fam-V;
Giollaráin	NP-Fam;
Giollarnáth	NP-Fam;
!!Gíolla Rua	NP-Fam-V;
Glacáin	NP-Fam;
Gláimhín	NP-Fam;
Glainbhíol	NP-Fam;
Glaiséid	NP-Fam;
Glaisín	NP-Fam;
Glaisne	NP-Fam;
Glaisne	NP-Fam;
Glasáin	NP-Fam;
Glas	NP-Fam;
Gleadra	NP-Fam-V;
Gléasúr	NP-Fam;
Gliasáin	NP-Fam;
Gliasáin	NP-Fam;
Glóiairn	NP-Fam;
Glúin	NP-Fam;
Gnímh	NP-Fam;
Gobáin	NP-Fam;
Gobhann	NP-Fam;
Gobhann	NP-Fam;
Gógan	NP-Fam;
Goibheanaigh	NP-Fam-chg;
Goibín	NP-Fam;
Góilin	NP-Fam;
Góilín	NP-Fam;
Goill	NP-Fam;
Góiséir	NP-Fam;
Góislín	NP-Fam;
Góislín	NP-Fam;
Golláin	NP-Fam;
Gormagáin	NP-Fam;
Gormaile	NP-Fam;
Gormáin	NP-Fam;
Gorthraigh	NP-Fam-chg;
Gothmann	NP-Fam;
Gothraidh	NP-Fam;
Gothraidh	NP-Fam;
Gráda	NP-Fam-V;
Grae	NP-Fam;
Gráinne	NP-Fam;
Gráinseach	NP-Fam-0;
Gráinséir	NP-Fam;
Gramhna	NP-Fam-V;
Grandún	NP-Fam;
Grant	NP-Fam;
Grás	NP-Fam;
Gréacháin	NP-Fam;
Greada	NP-Fam-V;
Gréagair	NP-Fam;
Gréibh	NP-Fam;
Griabháin	NP-Fam;
Grianáin	NP-Fam;
Grianna	NP-Fam-V;
Gribín	NP-Fam;
Grífín	NP-Fam;
Gríocha	NP-Fam-V;
Gríofa	NP-Fam-V;
Griogair	NP-Fam;
Grioghair	NP-Fam;
Gromail	NP-Fam;
Gruagáin	NP-Fam;
Guagáin	NP-Fam;
Guaigín	NP-Fam;
Guaire	NP-Fam;
Guaire	NP-Fam;
Guairim	NP-Fam;
Gualraic	NP-Fam;
Gualraic	NP-Fam;
Gud	NP-Fam;
Guidh	NP-Fam;
Gúilí	NP-Fam;
Gúilí	NP-Fam;
Guiní	NP-Fam;
Guin	NP-Fam;
Gúl	NP-Fam;
Gúl	NP-Fam;
Gumartún	NP-Fam;
Gunna	NP-Fam-V;
Gunnar	NP-Fam;
Gusáin	NP-Fam;
Gusáin	NP-Fam;
Hae	NP-Fam;
Haicéid	NP-Fam;
Haimlín	NP-Fam;
Hairdín	NP-Fam;
Halabhóid	NP-Fam;
Halbhuí	NP-Fam;
Hál	NP-Fam;
Haltún	NP-Fam;
Hamaltún	NP-Fam;
Hamróg	NP-Fam;
Hamtún	NP-Fam;
Hancard	NP-Fam;
Hancóc	NP-Fam;
Handbura	NP-Fam-V;
Haol	NP-Fam;
Haróid	NP-Fam;
Harpúr	NP-Fam;
Héadún	NP-Fam;
Hearfort	NP-Fam;
Hearman	NP-Fam;
Héibheart	NP-Fam;
Héil	NP-Fam;
Héíl	NP-Fam;
Hibeard	NP-Fam;
Hindeberg	NP-Fam;
!!hÍr	NP-Fam;
Ír	NP-Fam;
Hobacán	NP-Fam;
Hobac	NP-Fam;
Hobard	NP-Fam;
Hob	NP-Fam;
Hochtún	NP-Fam;
Hoibeard	NP-Fam;
!!hOibicín	NP-Fam;
Oibicín	NP-Fam;
Hoileabard	NP-Fam;
Hoirbín	NP-Fam;
Hoireabaird	NP-Fam;
Hoireabaird	NP-Fam;
Hoireabard	NP-Fam;
Hoireabhard	NP-Fam;
Hoiste	NP-Fam;
Hoisticín	NP-Fam;
Hólt	NP-Fam;
Hóra	NP-Fam-V;
Hórsaigh	NP-Fam-chg;
Húighéid	NP-Fam;
Huigín	NP-Fam;
Húiléid	NP-Fam;
Húilín	NP-Fam;
Huiste	NP-Fam;
Hunfraidh	NP-Fam;
Iácób	NP-Fam;
Iagó	NP-Fam;
Iain	NP-Fam;
Iarla	NP-Fam-V;
Iarlatha	NP-Fam-V;
Iarnáin	NP-Fam;
Iasachta	NP-Fam-V;
Iascair	NP-Fam;
Icheallaigh	NP-Fam-chg;
Ící	NP-Fam;
Íde	NP-Fam;
Ifearnáin	NP-Fam;
Ilfearnáin	NP-Fam;
Inglis	NP-Fam;
Inglis	NP-Fam;
Inneachtaigh	NP-Fam-chg;
Innéiri	NP-Fam;
Innéirí	NP-Fam;
Innéirí	NP-Fam;
Inse	NP-Fam;
Ioláin	NP-Fam;
Iolracháin	NP-Fam;
Iomaire	NP-Fam;
Iomhair	NP-Fam;
Íomhair	NP-Fam;
Íomhair	NP-Fam;
Iongardail	NP-Fam;
Iongram	NP-Fam;
Ionnachtaigh	NP-Fam-chg;
Ionnaile	NP-Fam;
Ionnail	NP-Fam;
Ionnrachtaigh	NP-Fam-chg;
Ionrachtaigh	NP-Fam-chg;
Ionráin	NP-Fam;
Iontóg	NP-Fam;
Ionúine	NP-Fam;
Íorua	NP-Fam-V;
!!!Íosa	NP-Fam-V;
Íosa	NP-Fam-V;
Íosóg	NP-Fam;
Íréis	NP-Fam;
Irile	NP-Fam;
Iril	NP-Fam;
Írleont	NP-Fam;
Ír	NP-Fam;
Istéil	NP-Fam;
Iústáis	NP-Fam;
Iústás	NP-Fam;
Labhailin	NP-Fam;
Labhraidh	NP-Fam;
Labhrainn	NP-Fam;
Labhráin	NP-Fam;
Labhráin	NP-Fam;
Labhraí	NP-Fam;
Labhraí	NP-Fam;
Labhraí	NP-Fam;
Labhráis	NP-Fam;
Labhrás	NP-Fam;
Lacháin	NP-Fam;
Lachlainn	NP-Fam;
Lachláin	NP-Fam;
Lachtnáin	NP-Fam;
Lachtnáin	NP-Fam;
Lachtna	NP-Fam-V;
Lafáin	NP-Fam;
Lafán	NP-Fam;
Laghmainn	NP-Fam;
Laghmainn	NP-Fam;
Laibheartaigh	NP-Fam-chg;
Laideáin	NP-Fam;
láidir	NP-Fam;
Laifeartaigh	NP-Fam-chg;
Laifeartaigh	NP-Fam-chg;
Laigheanáin	NP-Fam;
Laighin	NP-Fam;
Laighléis	NP-Fam;
Laighneach	NP-Fam-0;
Laighnigh	NP-Fam-chg;
Laighnigh	NP-Fam-chg;
Laimbeart	NP-Fam;
Laimbín	NP-Fam;
Laimhín	NP-Fam;
Láimhín	NP-Fam;
Lainn	NP-Fam;
Lairgneáin	NP-Fam;
Laitheartaigh	NP-Fam-chg;
Laitheasa	NP-Fam-V;
Laithimh	NP-Fam;
Laithimh	NP-Fam;
Laíthimh	NP-Fam;
Laithín	NP-Fam;
Laitín	NP-Fam;
Lálaí	NP-Fam;
Langáin	NP-Fam;
Langfort	NP-Fam;
Langtún	NP-Fam;
Lannchaidh	NP-Fam;
Lannchaidh	NP-Fam;
!Lá	NP-Fam;
Lant	NP-Fam;
Laocha	NP-Fam-V;
LaoghÓg	NP-Fam;
Laoil	NP-Fam;
Laoi	NP-Fam;
Laoire	NP-Fam;
Laoire	NP-Fam;
Laoghaire	NP-Fam;
Lapáin	NP-Fam;
Lapáin	NP-Fam;
larsach	NP-Fam-0;
lascair	NP-Fam;
Léadar	NP-Fam;
Léadús	NP-Fam;
Leaindí	NP-Fam;
Leamhnach	NP-Fam-0;
Leamhna	NP-Fam-V;
Léanacháin	NP-Fam;
Leandáin	NP-Fam;
Leannacháin	NP-Fam;
Leannacháin	NP-Fam;
Leannáin	NP-Fam;
Leannáin	NP-Fam;
Leannáín	NP-Fam;
Learasa	NP-Fam-V;
Leaslaoi	NP-Fam;
Leastair	NP-Fam;
Leastar	NP-Fam;
Leatháin	NP-Fam;
Leathlobhair	NP-Fam;
Léid	NP-Fam;
Léid	NP-Fam;
Léime	NP-Fam;
Léis	NP-Fam;
Léíth	NP-Fam;
Lemass	NP-Fam;
Leocháin	NP-Fam;
Leocháin	NP-Fam;
Leogáin	NP-Fam;
Leoid	NP-Fam;
Leoid	NP-Fam;
Liain	NP-Fam;
Liammóir	NP-Fam;
Liam	NP-Fam;
Liam	NP-Fam;
Lia	NP-Fam-V;
Lia	NP-Fam-V;
Liatháin	NP-Fam;
Liath	NP-Fam;
Lidí	NP-Fam;
Linneáin	NP-Fam;
Liobhóid	NP-Fam;
Lioncól	NP-Fam;
Líongard	NP-Fam;
Lionóid	NP-Fam;
Liontún	NP-Fam;
Liostún	NP-Fam;
Lobhaois	NP-Fam;
Locard	NP-Fam;
Lócháin	NP-Fam;
Lochlainn	NP-Fam;
Lochlainn	NP-Fam;
Lochlain	NP-Fam;
Lochtús	NP-Fam;
Loideáin	NP-Fam;
Loidigh	NP-Fam-chg;
Lóid	NP-Fam;
Loighin	NP-Fam;
Loineagáin	NP-Fam;
Loineagáin	NP-Fam;
Loingeacháin	NP-Fam;
Loinge	NP-Fam;
Loinge	NP-Fam;
Loingseacháin	NP-Fam;
Loingsigh	NP-Fam-chg;
Loingsigh	NP-Fam-chg;
Loinín	NP-Fam;
Loinn	NP-Fam;
Loinscigh	NP-Fam-chg;
Loirgneáin	NP-Fam;
Loirg	NP-Fam;
Loiste	NP-Fam;
lolracháin	NP-Fam;
Lomaile	NP-Fam;
lomaíre	NP-Fam;
Lomasna	NP-Fam-V;
Lombard	NP-Fam;
Lomhaid	NP-Fam;
lomhair	NP-Fam;
lomna	NP-Fam-V;
Lonagáin	NP-Fam;
Londra	NP-Fam-V;
Londras	NP-Fam;
Londún	NP-Fam;
Longáin	NP-Fam;
Longáin	NP-Fam;
Longargáin	NP-Fam;
lonntóg	NP-Fam;
Lorcáin	NP-Fam;
Lordáin	NP-Fam;
Lorgnain	NP-Fam;
Lotrail	NP-Fam;
Luachaíre	NP-Fam;
Luachráin	NP-Fam;
Luachra	NP-Fam-V;
Luaidh	NP-Fam;
Luaidh	NP-Fam;
Lúaidh	NP-Fam;
luain	NP-Fam;
Luairinn	NP-Fam;
Luaithre	NP-Fam;
Luaithrinn	NP-Fam;
Luanaigh	NP-Fam-chg;
Luanáin	NP-Fam;
Luasaigh	NP-Fam-chg;
Luathéirí	NP-Fam;
Lubaigh	NP-Fam-chg;
Lúbaigh	NP-Fam-chg;
Lúcáis	NP-Fam;
Lúcáis	NP-Fam;
Luibhéid	NP-Fam;
Luibhéil	NP-Fam;
Luimbric	NP-Fam;
Luinigh	NP-Fam-chg;
Luirg	NP-Fam;
Lúiséid	NP-Fam;
Lú	NP-Fam;
Lusaigh	NP-Fam-chg;
Lústás	NP-Fam;
Máb	NP-Fam;
Maca	NP-Fam-V;
Macasa	NP-Fam-V;
Machail	NP-Fam;
Macháin	NP-Fam;
Macháin	NP-Fam;
Madagáin	NP-Fam;
Madaidh	NP-Fam;
Madáin	NP-Fam;
Madóg	NP-Fam;
Mághún	NP-Fam;
Máibín	NP-Fam;
Maicin	NP-Fam;
Maicín	NP-Fam;
Maighe	NP-Fam;
Máighe	NP-Fam;
Máighiú	NP-Fam;
Máilleach	NP-Fam-0;
Máille	NP-Fam;
Mainchín	NP-Fam;
Maine	NP-Fam;
Maingnéir	NP-Fam;
Máinle	NP-Fam;
Mainnín	NP-Fam;
Máirtín	NP-Fam;
Máirtín	NP-Fam;
Maithís	NP-Fam;
Maitiú	NP-Fam;
Manacháin	NP-Fam;
Mánais	NP-Fam;
Manaráin	NP-Fam;
Mánasa	NP-Fam-V;
Manóg	NP-Fam;
Mantáin	NP-Fam;
Maoftuile	NP-Fam;
Maoilbheannachta	NP-Fam-V;
Maoilbheannachta	NP-Fam-V;
Maoilbheanóin	NP-Fam;
Maoilbhearaigh	NP-Fam-chg;
Maoilbhréanainn	NP-Fam;
Maoilbhreandáin	NP-Fam;
Maoilbhríde	NP-Fam;
Maoilchéire	NP-Fam;
Maoilchiaráin	NP-Fam;
Maoildeirg	NP-Fam;
Maoileacháin	NP-Fam;
Maoileachlainn	NP-Fam;
Maoileagáin	NP-Fam;
Maoileáin	NP-Fam;
Maoileanaigh	NP-Fam-chg;
Maoilearca	NP-Fam-V;
Maoilearna	NP-Fam-V;
Maoiléidigh	NP-Fam-chg;
Maoiléimhín	NP-Fam;
Maoileoin	NP-Fam;
Maoilgheiric	NP-Fam;
Maoilinn	NP-Fam;
Maoilín	NP-Fam;
Maoilíosa	NP-Fam-V;
Maoilir	NP-Fam;
Maoilmhána	NP-Fam-V;
Maoilmheana	NP-Fam-V;
Maoilmheanna	NP-Fam-V;
Maoilmheá	NP-Fam;
Maoilmhiaigh	NP-Fam-chg;
Maoilmhichil	NP-Fam;
Maoilmhichíl	NP-Fam;
Maoilmhin	NP-Fam;
Maoilmhín	NP-Fam;
Maoilpheadair	NP-Fam;
Maoilréana	NP-Fam-V;
Maoilriabhaigh	NP-Fam-chg;
Maoilriain	NP-Fam;
Maoilsionóg	NP-Fam;
Maoilsté	NP-Fam;
Maolábhail	NP-Fam;
Maolacháin	NP-Fam;
Maolachtna	NP-Fam-V;
Maolagáin	NP-Fam;
Maolagáin	NP-Fam;
Maolaiche	NP-Fam;
Maolainfe	NP-Fam;
Maoláin	NP-Fam;
Maoláin	NP-Fam;
Maolalaidh	NP-Fam;
Maolanfaidh	NP-Fam;
Maolaodha	NP-Fam-V;
Maolaodhóg	NP-Fam;
Maolaoidh	NP-Fam;
Maolathartaigh	NP-Fam-chg;
Maolbháin	NP-Fam;
Maolchairill	NP-Fam;
Maolchaisil	NP-Fam;
Maolchaisil	NP-Fam;
Maolchallann	NP-Fam;
Maolchaoine	NP-Fam;
Maolchaoin	NP-Fam;
Maolchatáin	NP-Fam;
Maolchathaigh	NP-Fam-chg;
Maolchathail	NP-Fam;
Maolchluiche	NP-Fam;
Maolcholaim	NP-Fam;
Maolchomadh	NP-Fam;
Maolchonaire	NP-Fam;
Maolchraoibhe	NP-Fam;
Maolchróine	NP-Fam;
Maolchróin	NP-Fam;
Maoldomhnaigh	NP-Fam-chg;
Maoldoraidh	NP-Fam;
Maoldúin	NP-Fam;
Maolfabhail	NP-Fam;
Maolfhachtna	NP-Fam-V;
Maolghaoithe	NP-Fam;
Maolluibh	NP-Fam;
Maolmhaodhóg	NP-Fam;
Maolmhuaidh	NP-Fam;
Maolmhuire	NP-Fam;
Maolmochéirí	NP-Fam;
Maolmona	NP-Fam-V;
Maolmóna	NP-Fam-V;
Maolmuaidh	NP-Fam;
Maolómhair	NP-Fam;
Maolomhnaigh	NP-Fam-chg;
Maolphádraig	NP-Fam;
Maolruanaidh	NP-Fam;
Maolrua	NP-Fam-V;
Maoltuile	NP-Fam;
Maoluala	NP-Fam-V;
Maoluibh	NP-Fam;
Maonaigh	NP-Fam-chg;
Maonaile	NP-Fam;
Maongail	NP-Fam;
Maothagáin	NP-Fam;
Máp	NP-Fam;
Marannáin	NP-Fam;
Marascal	NP-Fam;
Marcacháin	NP-Fam;
Marcaigh	NP-Fam-chg;
Marcais	NP-Fam;
Mascasa	NP-Fam-V;
Masún	NP-Fam;
Matha	NP-Fam-V;
Mathúna	NP-Fam-V;
Meachair	NP-Fam;
Meachair	NP-Fam;
Meallaigh	NP-Fam-chg;
Mealláin	NP-Fam;
Méalóid	NP-Fam;
Méanart	NP-Fam;
Meanman	NP-Fam;
Meanma	NP-Fam-V;
Mearaigh	NP-Fam-chg;
Mearáin	NP-Fam;
Meára	NP-Fam-V;
Meardha	NP-Fam-V;
Mearnáin	NP-Fam;
Mearthaile	NP-Fam;
Measaigh	NP-Fam-chg;
Meirgeach	NP-Fam-0;
Meirgín	NP-Fam;
Meiric	NP-Fam;
Meirleacháin	NP-Fam;
Meirnín	NP-Fam;
Meirtneach	NP-Fam-0;
Meiscill	NP-Fam;

Machaire	NP-Fam;
Machaire	NP-Fam;
Madaidh	NP-Fam;
Madaidh	NP-Fam;
Madaldh	NP-Fam;
Madóc	NP-Fam;
Madóg	NP-Fam;
Máistir	NP-Fam;
Maith	NP-Fam;
Maith	NP-Fam;
Manaigh	NP-Fam-chg;
Manaigh	NP-Fam-chg;
Mantaigh	NP-Fam-chg;
Maodhóg	NP-Fam;
Maoil	NP-Fam;
Maoil	NP-Fam;
Maoir	NP-Fam;
Maoldúin	NP-Fam;
Maonaigh	NP-Fam-chg;
Maonaigh	NP-Fam-chg;
Mártain	NP-Fam;
Mártain	NP-Fam;
Meana	NP-Fam-V;
Meana	NP-Fam-V;
Meanma	NP-Fam-V;
Mearáin	NP-Fam;
Mearáin	NP-Fam;
Mearnóg	NP-Fam;
Michil	NP-Fam;
Michil	NP-Fam;
Michíl	NP-Fam;
Mile	NP-Fam;
Míle	NP-Fam;
Mín	NP-Fam;
Mín	NP-Fam;
Míofchon	NP-Fam;
Míolchon	NP-Fam;
Mir	NP-Fam;
Muilinn	NP-Fam;
Muireartaigh	NP-Fam-chg;
Muireartaigh	NP-Fam-chg;
Muire	NP-Fam;
Muire	NP-Fam;
Muirí	NP-Fam;
Muirneacháin	NP-Fam;
Muirneacháin	NP-Fam;
Murchaidh	NP-Fam;

!Mhachaire	NP-Fam;
!Mhachaire	NP-Fam;
!Mhadaidh	NP-Fam;
!Mhadaidh	NP-Fam;
!Mhadaldh	NP-Fam;
!Mhadóc	NP-Fam;
!Mhadóg	NP-Fam;
!Mháistir	NP-Fam;
!Mhaith	NP-Fam;
!Mhaith	NP-Fam;
!Mhanaigh	NP-Fam-chg;
!Mhanaigh	NP-Fam-chg;
!Mhantaigh	NP-Fam-chg;
!Mhaodhóg	NP-Fam;
!Mhaoil	NP-Fam;
!Mhaoil	NP-Fam;
!Mhaoir	NP-Fam;
!Mhaoldúin	NP-Fam;
!Mhaonaigh	NP-Fam-chg;
!Mhaonaigh	NP-Fam-chg;
!Mhártain	NP-Fam;
!Mhártain	NP-Fam;
!Mheana	NP-Fam-V;
!Mheana	NP-Fam-V;
!Mheanma	NP-Fam-V;
!Mhearáin	NP-Fam;
!Mhearáin	NP-Fam;
!Mhearnóg	NP-Fam;
!Mhichil	NP-Fam;
!Mhichil	NP-Fam;
!Mhichíl	NP-Fam;
!Mhile	NP-Fam;
!Mhíle	NP-Fam;
!Mhín	NP-Fam;
!Mhín	NP-Fam;
!Mhíofchon	NP-Fam;
!Mhíolchon	NP-Fam;
!Mhir	NP-Fam;
!Mhuilinn	NP-Fam;
!Mhuireartaigh	NP-Fam-chg;
!Mhuireartaigh	NP-Fam-chg;
!Mhuire	NP-Fam;
!Mhuire	NP-Fam;
!Mhuirí	NP-Fam;
!Mhuirneacháin	NP-Fam;
!Mhuirneacháin	NP-Fam;
!Mhurchaidh	NP-Fam;

Miacháin	NP-Fam;
Miach	NP-Fam-0;
Miadhaigh	NP-Fam-chg;
Miagáin	NP-Fam;
Mianáin	NP-Fam;
Michilín	NP-Fam;
Michil	NP-Fam;
Minitéir	NP-Fam;
Minne	NP-Fam;
Míoluic	NP-Fam;
Mionacháin	NP-Fam;
Mír	NP-Fam;
Mochaín	NP-Fam;
Mocháin	NP-Fam;
Mochóir	NP-Fam;
Mochta	NP-Fam-V;
Modartha	NP-Fam-V;
Moicléir	NP-Fam;
Móinbhíol	NP-Fam;
Móinséil	NP-Fam;
Moiréis	NP-Fam;
Moirtéil	NP-Fam;
Moithide	NP-Fam;
Moitlé	NP-Fam;
Molacháin	NP-Fam;
Mongabháin	NP-Fam;
Mongaigh	NP-Fam-chg;
Mongáin	NP-Fam;
Mongalbháin	NP-Fam;
Móráin	NP-Fam;
Morna	NP-Fam-V;
Mortún	NP-Fam;
Muighe	NP-Fam;
Muilleoir	NP-Fam;
Muineacháin	NP-Fam;
Muíneacháin	NP-Fam;
Muíneach	NP-Fam-0;
Muineagáin	NP-Fam;
Muineog	NP-Fam;
Muínigh	NP-Fam-chg;
Muín	NP-Fam;
Muireagáin	NP-Fam;
Muireáin	NP-Fam;
Muirealtaigh	NP-Fam-chg;
Muíreartaígh	NP-Fam;
Muireartaigh	NP-Fam-chg;
Muireasáin	NP-Fam;
Muireasáin	NP-Fam;
Muireasa	NP-Fam-V;
Muirín	NP-Fam;
Muirí	NP-Fam;
Muirir	NP-Fam;
Muiris	NP-Fam;
Muiris	NP-Fam;
Muiris	NP-Fam-V;
Muirithe	NP-Fam;
Muírneacháin	NP-Fam;
Mulleague	NP-Fam;
Munna	NP-Fam-V;
Muraile	NP-Fam;
Muraláin	NP-Fam;
Muraláin	NP-Fam;
Múra	NP-Fam-V;
Murchaidh	NP-Fam;
Murchaídh	NP-Fam;
Murcháin	NP-Fam;
Murcháin	NP-Fam;
Murchu	NP-Fam;
Murchú	NP-Fam;
Murnáin	NP-Fam;
Murnáin	NP-Fam;
Murthuíle	NP-Fam;
Nailín	NP-Fam;
Naíonáin	NP-Fam;
Nais	NP-Fam;
Naois	NP-Fam;
Náraigh	NP-Fam-chg;
Nása	NP-Fam-V;
Náthan	NP-Fam;
Neachtain	NP-Fam;
Neachtaín	NP-Fam;
Neadraibhíol	NP-Fam;
Neighill	NP-Fam;
Neighil	NP-Fam;
Néill	NP-Fam;
Né	NP-Fam;
Neothallaigh	NP-Fam-chg;
Niallagáin	NP-Fam;
Niallain	NP-Fam;
Nialláin	NP-Fam;
Niallais	NP-Fam;
Niallais	NP-Fam;
Nia	NP-Fam-V;
Nía	NP-Fam-V;
Niatháin	NP-Fam;
Niocaill	NP-Fam;
Niocais	NP-Fam;
Niocláis	NP-Fam;
Nógla	NP-Fam-V;
Noiréis	NP-Fam;
Noraidh	NP-Fam;
Nuad	NP-Fam;
Nuáin	NP-Fam;
Nualláin	NP-Fam;
Nuaman	NP-Fam;
Nuanáin	NP-Fam;
Nuat	NP-Fam;
Nuinseann	NP-Fam;
Nútáin	NP-Fam;
Ódach	NP-Fam-0;
Oda	NP-Fam-V;
Óda	NP-Fam-V;
Ógáin	NP-Fam;
Ógairt	NP-Fam;
Ógartaigh	NP-Fam-chg;
Óghartaigh	NP-Fam-chg;
Oglaoich	NP-Fam;
Oibicín	NP-Fam;
Oileabhard	NP-Fam;
Oilibhéar	NP-Fam;
Oirc	NP-Fam;
Oíreachtaígh	NP-Fam;
Oireachtaigh	NP-Fam-chg;
Oirghialla	NP-Fam-chg;
Oirghialla	NP-Fam-V;
Oisín	NP-Fam;
Oiste	NP-Fam;
Oistigín	NP-Fam;
Oistín	NP-Fam;
Oístín	NP-Fam;
Oistir	NP-Fam;
Oitir	NP-Fam;
Oláin	NP-Fam;
Onchon	NP-Fam;
Óráin	NP-Fam;
Óra	NP-Fam-V;
Orcáin	NP-Fam;
Orraistín	NP-Fam;
Órsaigh	NP-Fam-chg;
Osáin	NP-Fam;
Oscair	NP-Fam;
Ospaic	NP-Fam;
Osraic	NP-Fam;
Paghan	NP-Fam;
Páidín	NP-Fam;
Pailís	NP-Fam;
Painín	NP-Fam;
Páircéir	NP-Fam;
Páiris	NP-Fam;
Paislig	NP-Fam;
Paor	NP-Fam;
Páraicín	NP-Fam;
Parthaláin	NP-Fam;
Parthaláin	NP-Fam;
Péacóg	NP-Fam;
Péagam	NP-Fam;
Peáircín	NP-Fam;
Pearail	NP-Fam;
Pearóid	NP-Fam;
Péaslaí	NP-Fam;
Peatáin	NP-Fam;
Péice	NP-Fam;
Peitíd	NP-Fam;

Pádraig	NP-Fam;
Páidín	NP-Fam;
Páidí	NP-Fam;
Páid	NP-Fam;
Páil	NP-Fam;
Páraicín	NP-Fam;
Parláin	NP-Fam;
Parthaláin	NP-Fam;
Pátraic	NP-Fam;
!Pheadair	NP-Fam;	! see np-lex-stems & np-lex-pers
Peadrais	NP-Fam;
Peadrais	NP-Fam;
Pearsúin	NP-Fam;
Pearsúin	NP-Fam;
Piaraic	NP-Fam;
Piarais	NP-Fam;
Pibín	NP-Fam;
Pib	NP-Fam;
Pilbín	NP-Fam;
Pilibín	NP-Fam;
Pilib	NP-Fam;
Póil	NP-Fam;
Príora	NP-Fam-V;
Prír	NP-Fam;
Pristeaird	NP-Fam;


!Phádraig	NP-Fam;
!Pháidín	NP-Fam;
!Pháidí	NP-Fam;
!Pháid	NP-Fam;
!Pháil	NP-Fam;
!Pháraicín	NP-Fam;
!Pharláin	NP-Fam;
!Pharthaláin	NP-Fam;
!Phátraic	NP-Fam;
!!!Pheadair	NP-Fam;	! see np-lex-stems & np-lex-pers
!Pheadrais	NP-Fam;
!Pheadrais	NP-Fam;
!Phearsúin	NP-Fam;
!Phearsúin	NP-Fam;
!Phiaraic	NP-Fam;
!Phiarais	NP-Fam;
!Phibín	NP-Fam;
!Phib	NP-Fam;
!Philbín	NP-Fam;
!Philbín	NP-Fam;
!Philibín	NP-Fam;
!Philib	NP-Fam;
!Phóil	NP-Fam;
!Phóil	NP-Fam;
!Phríora	NP-Fam-V;
!Phríora	NP-Fam-V;
!Phrír	NP-Fam;
!Phristeaird	NP-Fam;
Piarais	NP-Fam;
Píc	NP-Fam;
Pilin	NP-Fam;
Piobaire	NP-Fam;
Piobart	NP-Fam;
Piogóid	NP-Fam;
Piombróg	NP-Fam;
Piondar	NP-Fam;
Pléimeann	NP-Fam;
Pluincéid	NP-Fam;
Póiléid	NP-Fam;
Póilín	NP-Fam;
Póil	NP-Fam;
Poire	NP-Fam;
Póirtéir	NP-Fam;
Poirtingéil	NP-Fam;
Polard	NP-Fam;
Polóc	NP-Fam;
Pomrae	NP-Fam;
Potar	NP-Fam;
Prát	NP-Fam;
Preastún	NP-Fam;
Préith	NP-Fam;
Priocaird	NP-Fam;
Priodháil	NP-Fam;
Príodháil	NP-Fam;
Priondragás	NP-Fam;
Prionnbhiól	NP-Fam;
Prionnbhíol	NP-Fam;
Prís	NP-Fam;
Proinséis	NP-Fam;
Pronntaigh	NP-Fam-chg;
Prút	NP-Fam;
Púdarlaigh	NP-Fam-chg;
Púinse	NP-Fam;
Puirséil	NP-Fam;
Rabhartaigh	NP-Fam-chg;
Rachtagáin	NP-Fam;
Raghailligh	NP-Fam-chg;
Raghaill	NP-Fam;
Rághaill	NP-Fam;
Raghail	NP-Fam;
Raghallaigh	NP-Fam-chg;
Raghallaigh	NP-Fam-chg;
Raghat	NP-Fam;
Raghnainn	NP-Fam;
Raghnard	NP-Fam;
Raichtín	NP-Fam;
Raifeartaigh	NP-Fam-chg;
Raifearthaigh	NP-Fam-chg;
Raifeataigh	NP-Fam-chg;
Raighne	NP-Fam;
Raigilligh	NP-Fam-chg;
Raigilligh	NP-Fam-chg;
Raigill	NP-Fam;
Ráill	NP-Fam;
Ráine	NP-Fam;
Raing	NP-Fam;
ráin	NP-Fam;
Ráin	NP-Fam;
Raistric	NP-Fam;
Raithile	NP-Fam;
Raithne	NP-Fam;
Raith	NP-Fam;
Raith	NP-Fam;
Rálaigh	NP-Fam-chg;
Rállaigh	NP-Fam-chg;
Rállalgh	NP-Fam;
Ramsaigh	NP-Fam-chg;
Ránaill	NP-Fam;
Ránaill	NP-Fam;
Ránainn	NP-Fam;
Randal	NP-Fam;
Raois	NP-Fam;
Raois	NP-Fam;
Raollaigh	NP-Fam-chg;
Ratha	NP-Fam-V;
Ráth	NP-Fam;
Ráulbh	NP-Fam;
Réabaigh	NP-Fam-chg;
Reachair	NP-Fam;
Reachtagáin	NP-Fam;
Reachtain	NP-Fam;
Reachtain	NP-Fam;
Reachtaire	NP-Fam;
Reachtair	NP-Fam;
Reachtnín	NP-Fam;
Réamainn	NP-Fam;
Réamann	NP-Fam;
Réamonn	NP-Fam;
Reannachain	NP-Fam;
Reannacháin	NP-Fam;
Reannacháin	NP-Fam;
Reighill	NP-Fam;
Réill	NP-Fam;
Réill	NP-Fam;
Riabhach	NP-Fam-0;
Riabhaígh	NP-Fam;
Riabhaigh	NP-Fam-chg;
Riabhaigh	NP-Fam-chg;
Ríabhaigh	NP-Fam-chg;
Riada	NP-Fam-V;
Riada	NP-Fam-V;
Riagáin	NP-Fam;
Riagáin	NP-Fam;
Riain	NP-Fam;
Rialláin	NP-Fam;
Riallais	NP-Fam;
Ricéid	NP-Fam;
Ricéid	NP-Fam;
Rideal	NP-Fam;
Ridire	NP-Fam;
Ridire	NP-Fam;
Rifeartaigh	NP-Fam-chg;
Rifeartaigh	NP-Fam-chg;
Rímheá	NP-Fam;
Rinn	NP-Fam;
Riocaird	NP-Fam;
Riocaird	NP-Fam;
Riodal	NP-Fam;
Riordáin	NP-Fam;
Ríordáin	NP-Fam;
Riseamann	NP-Fam;
Rís	NP-Fam;
Risteaird	NP-Fam;
Robhartaigh	NP-Fam-chg;
Rob	NP-Fam;
Rob	NP-Fam;
Rodacháin	NP-Fam;
Rodaigh	NP-Fam-chg;
Rodáin	NP-Fam;
Rodáin	NP-Fam;
Rodhmann	NP-Fam;
Rodhulbh	NP-Fam;
Roghaill	NP-Fam;
Roibeaird	NP-Fam;
Roibeard	NP-Fam;
Roibheal	NP-Fam;
Roibín	NP-Fam;
Roibín	NP-Fam;
Roideacháin	NP-Fam;
Roideáin	NP-Fam;
Roidigh	NP-Fam-chg;
Roigne	NP-Fam;
Roileacháin	NP-Fam;
Rois	NP-Fam;
Róisteach	NP-Fam-0;
Róiste	NP-Fam;
Rónáin	NP-Fam;
Rosach	NP-Fam-0;
Rosaitear	NP-Fam;
Rosfort	NP-Fam;
Rosna	NP-Fam-V;
Rós	NP-Fam;
Róthaich	NP-Fam;
Rothláin	NP-Fam;
Ruacháin	NP-Fam;
Ruadháin	NP-Fam;
Ruagáin	NP-Fam;
Ruaín	NP-Fam;
Ruáin	NP-Fam;
Ruáin	NP-Fam;
Ruairc	NP-Fam;
Ruairí	NP-Fam;
Ruairí	NP-Fam;
Ruanaidh	NP-Fam;
Ruanaín	NP-Fam;
Ruanáin	NP-Fam;
Ruandha	NP-Fam-V;
rua	NP-Fam-V;
Rua	NP-Fam-V;
Ruarcáin	NP-Fam;
Ruarí	NP-Fam;
Ruartaigh	NP-Fam-chg;
Rucstún	NP-Fam;
Rughasa	NP-Fam-V;
Ruirí	NP-Fam;
Ruiséil	NP-Fam;
Rút	NP-Fam;
Sabháin	NP-Fam;
Sabhaois	NP-Fam;
Sabhrainn	NP-Fam;
Sagairt	NP-Fam;
Saghas	NP-Fam;
Sailigéir	NP-Fam;
Sailingéir	NP-Fam;
Sairgeant	NP-Fam;
Sáirgeant	NP-Fam;
Sáirséil	NP-Fam;
Sáiséil	NP-Fam;
Salaigh	NP-Fam-chg;
Sál	NP-Fam;
Sámhaigh	NP-Fam-chg;
Samsún	NP-Fam;
Samuel	NP-Fam;
Sandair	NP-Fam;
Sandal	NP-Fam;
Sanfort	NP-Fam;
Saobhard	NP-Fam;
Saoghair	NP-Fam;
Saoghar	NP-Fam;
Saográbh	NP-Fam;
Saograobh	NP-Fam;
Saoi	NP-Fam;
Saoi	NP-Fam;
Saoir	NP-Fam;
Saoir	NP-Fam;
Saomar	NP-Fam;
Saomhar	NP-Fam;
Saoraí	NP-Fam;
Saoraí	NP-Fam;
Saraí	NP-Fam;
Sasanaigh	NP-Fam-chg;
Scadáin	NP-Fam;
Scaithil	NP-Fam;
Scalai	NP-Fam;
Scalaí	NP-Fam;
Scamatún	NP-Fam;
Scannail	NP-Fam;
Scannláin	NP-Fam;
Scathail	NP-Fam;
Sceacháin	NP-Fam;
Scealai	NP-Fam;
Scéalas	NP-Fam;
Scealláin	NP-Fam;
Scealtún	NP-Fam;
Sceimhealtún	NP-Fam;
Scideach	NP-Fam-0;
Scillinn	NP-Fam;
Scinéir	NP-Fam;
Scingín	NP-Fam;
Sciréid	NP-Fam;
Scoful	NP-Fam;
Scóful	NP-Fam;
Scolaí	NP-Fam;
Scolard	NP-Fam;
Scolláin	NP-Fam;
Scolóige	NP-Fam;
ScolÓige	NP-Fam;
Scorlóg	NP-Fam;
Scot	NP-Fam;
Scribhin	NP-Fam;
Scrín	NP-Fam;
Scurra	NP-Fam-V;
Seaca	NP-Fam-V;
Séacháin	NP-Fam;
Seachlainn	NP-Fam;
Seachlainn	NP-Fam;
Seachnais	NP-Fam;
Seachnasaigh	NP-Fam-chg;
Seách	NP-Fam;
Seac	NP-Fam;
Seafraidh	NP-Fam;
Seafraigh	NP-Fam-chg;
Seáin	NP-Fam;
Seáin	NP-Fam;
Sealbhaigh	NP-Fam-chg;
Sealmair	NP-Fam;
Séamais	NP-Fam;
Séamas	NP-Fam;
Seambar	NP-Fam;
Seamróg	NP-Fam;
Seanacháin	NP-Fam;
Seanachair	NP-Fam;
Seanaigh	NP-Fam-chg;
Seanáin	NP-Fam;
Seanáin	NP-Fam;
Seancháin	NP-Fam;
Seancha	NP-Fam-V;
Seanlaoich	NP-Fam;
Seantrabh	NP-Fam;
Searbháin	NP-Fam;
Searcaigh	NP-Fam-chg;
Searcóid	NP-Fam;
Séarlais	NP-Fam;
Searman	NP-Fam;
Searraigh	NP-Fam-chg;
Searraigh	NP-Fam-chg;
Seartáin	NP-Fam;
Séartha	NP-Fam-V;
Séarthúin	NP-Fam;
Seasnáin	NP-Fam;
Seathanaigh	NP-Fam-chg;
Seibhleáin	NP-Fam;
Seighin	NP-Fam;
Seinicín	NP-Fam;
Seitheacháin	NP-Fam;
Sé	NP-Fam;			!!!! why was this (and mí and lú)in lower case????? EUD 2012
Seoigh	NP-Fam-chg;
Seoin	NP-Fam;
Seortús	NP-Fam;

Sámhais	NP-Fam;
Samhráin	NP-Fam;
Seachlainn	NP-Fam;
Séamais	NP-Fam;
Seanlaoich	NP-Fam;
Seoinín	NP-Fam;
Simí	NP-Fam;
Sim	NP-Fam;
Síomóin	NP-Fam;
Síthigh	NP-Fam-chg;
Sitric	NP-Fam;
Siúrtáin	NP-Fam;
Suibhne	NP-Fam;
Suile	NP-Fam;
Súiligh	NP-Fam-chg;


!Shámhais	NP-Fam;
!Shamhráin	NP-Fam;
!Shamhráin	NP-Fam;
!Sheachlainn	NP-Fam;
!Shéamais	NP-Fam;
!Sheanlaoich	NP-Fam;
!Sheoinín	NP-Fam;
!Shimí	NP-Fam;
!Shim	NP-Fam;
!Shíomóin	NP-Fam;
!Shíthigh	NP-Fam-chg;
!Shitric	NP-Fam;
!Shitric	NP-Fam;
!Shiúrtáin	NP-Fam;
!Shuibhne	NP-Fam;
!Shuile	NP-Fam;
!Shúiligh	NP-Fam-chg;
Siacais	NP-Fam;
Siacas	NP-Fam;
Siail	NP-Fam;
Síbhear	NP-Fam;
Sigín	NP-Fam;
Simicín	NP-Fam;
Sincléir	NP-Fam;
Singealtún	NP-Fam;
Sing	NP-Fam;
Sinicín	NP-Fam;
Siocháin	NP-Fam;
Síocháin	NP-Fam;
Siochrú	NP-Fam;
síoda	NP-Fam-V;
Síoghair	NP-Fam;
Siomcóg	NP-Fam;
Síomóin	NP-Fam;
Síomóin	NP-Fam;
Sionacháin	NP-Fam;
Sionáin	NP-Fam;
Sionáin	NP-Fam;
Siondaile	NP-Fam;
Sionnaigh	NP-Fam-chg;
Sionnaigh	NP-Fam-chg;
Sionóid	NP-Fam;
Sionúir	NP-Fam;
Síoráin	NP-Fam;
Siordáin	NP-Fam;
Siosta	NP-Fam-V;
Sirideáin	NP-Fam;
Sírín	NP-Fam;
Siseal	NP-Fam;
Síthigh	NP-Fam-chg;
Siúinéir	NP-Fam;
Siúit	NP-Fam;
Siúlaí	NP-Fam;
Siún	NP-Fam;
Siúnta	NP-Fam-V;
Siúrtáin	NP-Fam;
Sláine	NP-Fam;
Slatara	NP-Fam-V;
Sléibhín	NP-Fam;
Sleimhne	NP-Fam;
Slócam	NP-Fam;
Sluaigh	NP-Fam-chg;
Sluáin	NP-Fam;
Smealláin	NP-Fam;
Smeart	NP-Fam;
Smidic	NP-Fam;
Smidí	NP-Fam;
Smist	NP-Fam;
Smolláin	NP-Fam;
Sneachta	NP-Fam-V;
Sní	NP-Fam;
Snodaigh	NP-Fam-chg;
Sochlacháin	NP-Fam;
Sochlaigh	NP-Fam-chg;
Soilligh	NP-Fam-chg;
Soirtéil	NP-Fam;
Solaimh	NP-Fam;
Somacháin	NP-Fam;
Somhairle	NP-Fam;
Soracháin	NP-Fam;
Spadáin	NP-Fam;
Spáidín	NP-Fam;
Spáinneach	NP-Fam-0;
Sparáin	NP-Fam;
Sparáin	NP-Fam;
Spealáin	NP-Fam;
Spealasa	NP-Fam-V;
Spéiring	NP-Fam;
Spéit	NP-Fam;
Sprat	NP-Fam;
Srabhóg	NP-Fam;
Sraitheáin	NP-Fam;
Srianáin	NP-Fam;
Srutháin	NP-Fam;
Srutháin	NP-Fam;
Stacapúl	NP-Fam;
Stac	NP-Fam;
Stafort	NP-Fam;
Stáineas	NP-Fam;
Stainléigh	NP-Fam-chg;
Stancard	NP-Fam;
Stanfort	NP-Fam;
Starcaidh	NP-Fam;
Stibhin	NP-Fam;
Stín	NP-Fam;
Stíobhard	NP-Fam;
Stiofáin	NP-Fam;
Stiofáin	NP-Fam;
Stocaire	NP-Fam;
Stocaire	NP-Fam;
Stocman	NP-Fam;
Stóc	NP-Fam;
Stóibín	NP-Fam;
Stoirín	NP-Fam;
Stóirín	NP-Fam;
Stondún	NP-Fam;
Stráinse	NP-Fam;
Straoits	NP-Fam;
Strong	NP-Fam;
Studart	NP-Fam;
Stúndún	NP-Fam;
Suain	NP-Fam;
Suaird	NP-Fam;
Suan	NP-Fam;
Suantún	NP-Fam;
Suatman	NP-Fam;
Suibhne	NP-Fam;
Suigin	NP-Fam;
Súileacháin	NP-Fam;
Súiligh	NP-Fam-chg;
Súilleabháin	NP-Fam;
Suingean	NP-Fam;
Suipéil	NP-Fam;
Súiste	NP-Fam;
Suitséir	NP-Fam;
Sútar	NP-Fam;
Sutún	NP-Fam;
Tadhgáin	NP-Fam;
Taidhg	NP-Fam;
Táilliúir	NP-Fam;
Tailtigh	NP-Fam-chg;
Taindí	NP-Fam;
Taithligh	NP-Fam-chg;
Talant	NP-Fam;
Talbóid	NP-Fam;
Talchair	NP-Fam;
Talcharáin	NP-Fam;
Talún	NP-Fam;
Támhais	NP-Fam;
Tanaidheáin	NP-Fam;
Tánaiste	NP-Fam;
Tancard	NP-Fam;
Tanúir	NP-Fam;
Taoiling	NP-Fam;
Taoisigh	NP-Fam-chg;
Taoisigh	NP-Fam-chg;
Tarnaigh	NP-Fam-chg;
Tarpaigh	NP-Fam-chg;
Tarsnáin	NP-Fam;
Táth	NP-Fam;
Téacháin	NP-Fam;
Teangana	NP-Fam-V;
Teathnaigh	NP-Fam-chg;
Teibhlin	NP-Fam;
Téimheáin	NP-Fam;
Teimhin	NP-Fam;
Teimhneáin	NP-Fam;
Teimhnín	NP-Fam;
Teisce	NP-Fam;
Teitheacháin	NP-Fam;


Taidhg	NP-Fam;
Támhais	NP-Fam;
Tiarnáin	NP-Fam;
Toirealaigh	NP-Fam-chg;
Tómaic	NP-Fam;
Tómais	NP-Fam;
Tom	NP-Fam;
Torcadail	NP-Fam;
Torcaill	NP-Fam;
Tréinir	NP-Fam;


!Thaidhg	NP-Fam;
!Thámhais	NP-Fam;
!Thiarnáin	NP-Fam;
!Thoirealaigh	NP-Fam-chg;
!Thómaic	NP-Fam;
!Thómais	NP-Fam;
!Thom	NP-Fam;
!Thorcadail	NP-Fam;
!Thorcaill	NP-Fam;
!Thréinir	NP-Fam;

Tiarnaigh	NP-Fam-chg;
Tiarnáin	NP-Fam;
Tincléir	NP-Fam;
Tiobraide	NP-Fam;
Tiomáin	NP-Fam;
Tiománaí	NP-Fam;
Tiompail	NP-Fam;
Tiompánaigh	NP-Fam-chg;
Tiompánaigh	NP-Fam-chg;
Tirial	NP-Fam;
Tiúit	NP-Fam;
Tiú	NP-Fam;
Tnúthail	NP-Fam;
Tóc	NP-Fam;
Tofa	NP-Fam-V;
Toghdha	NP-Fam-V;
Tóibín	NP-Fam;
Tóimicín	NP-Fam;
Toimilín	NP-Fam;
Toimín	NP-Fam;
Toirc	NP-Fam;
Toirealaigh	NP-Fam-chg;
Tomáis	NP-Fam;
Tomaltaigh	NP-Fam-chg;
Tomhnair	NP-Fam;
Tomhrair	NP-Fam;
Tóm	NP-Fam;
Tonnaigh	NP-Fam-chg;
Tón	NP-Fam;
Toráin	NP-Fam;
Torbóid	NP-Fam;
Torcaill	NP-Fam;
Tormaigh	NP-Fam-chg;
Tornail	NP-Fam;
Torna	NP-Fam-V;
Tornóir	NP-Fam;
Tórpa	NP-Fam-V;
Treabhair	NP-Fam;
Treant	NP-Fam;
Treasaigh	NP-Fam-chg;
Treodáin	NP-Fam;
Trinse	NP-Fam;
Triúman	NP-Fam;
Triú	NP-Fam;
Troim	NP-Fam;
Troithigh	NP-Fam-chg;
Trostan	NP-Fam;
!tSagairt	NP-Fam;
!tSámhaigh	NP-Fam-chg;
Sámhaigh	NP-Fam-chg;
!tSaoi	NP-Fam;
!tSaoir	NP-Fam;
!tSasanaigh	NP-Fam-chg;
Sasanaigh	NP-Fam-chg;
!tSeachlainn	NP-Fam;
!tSionnaigh	NP-Fam-chg;
Sionnaigh	NP-Fam-chg;
Tuachair	NP-Fam;
Tuairisc	NP-Fam;
Tuamáin	NP-Fam;
Tuama	NP-Fam-V;
Tuataigh	NP-Fam-chg;
Tuatail	NP-Fam;
Tuathaigh	NP-Fam-chg;
Tuathaile	NP-Fam;
Tuathail	NP-Fam;
Tuathaláin	NP-Fam;
Tuile	NP-Fam;
Tuile	NP-Fam;
Túinléigh	NP-Fam-chg;
Tuiridh	NP-Fam;
Tundar	NP-Fam;
Uachan	NP-Fam;
Uada	NP-Fam-V;
Uadhaigh	NP-Fam-chg;
Uaidín	NP-Fam;
Uaid	NP-Fam;
Uaid	NP-Fam;
UaIlacháin	NP-Fam;
Uaine	NP-Fam;
Uainí	NP-Fam;
Uais	NP-Fam;
Uaitéir	NP-Fam;
Uaithnín	NP-Fam;
Uait	NP-Fam;
Ualghairg	NP-Fam;
Uallacháin	NP-Fam;
Uallacháin	NP-Fam;
Uallacháín	NP-Fam;
Uallaigh	NP-Fam-chg;
Ualraig	NP-Fam;
Ualtair	NP-Fam;
Uanacháin	NP-Fam;
Uarais	NP-Fam;
Uaruisce	NP-Fam;
Uaruisce	NP-Fam;
Uastún	NP-Fam;
Úbáin	NP-Fam;
Úcaire	NP-Fam;
Úgáin	NP-Fam;
Ugán	NP-Fam;
Úgán	NP-Fam;
Uidhir	NP-Fam;
Uidhrín	NP-Fam;
Uidhrín	NP-Fam;
Uid	NP-Fam;
Uid	NP-Fam;
Uigeamór	NP-Fam;
Uiginn	NP-Fam;
Uiginn	NP-Fam;
Uilcín	NP-Fam;
Uilcín	NP-Fam;
Uileagóid	NP-Fam;
Uiliam	NP-Fam;
Uilic	NP-Fam;
Uilín	NP-Fam;
Uilí	NP-Fam;
Uilis	NP-Fam;
Uilliam	NP-Fam;
Uilliam	NP-Fam;
Uilliméid	NP-Fam;
Uíllíméíd	NP-Fam;
Uilmit	NP-Fam;
Uingil	NP-Fam;
Uingséil	NP-Fam;
Uinseannáin	NP-Fam;
Uinseann	NP-Fam;
Uír	NP-Fam;
Uír	NP-Fam;
Uisce	NP-Fam;
Uiscín	NP-Fam;
Uiscín	NP-Fam;
Uiséir	NP-Fam;
Úisfín	NP-Fam;
Úistín	NP-Fam;
Úistín	NP-Fam;
Uitheachair	NP-Fam;
Uladh	NP-Fam;
Ulcín	NP-Fam;
Ultacháin	NP-Fam;
Ultach	NP-Fam-0;
Ultaigh	NP-Fam-chg;
Ultaigh	NP-Fam-chg;
Ultáin	NP-Fam;
Ultalgh	NP-Fam;
Unfraidh	NP-Fam;
Uptún	NP-Fam;
Urnaí	NP-Fam;
Urthuile	NP-Fam;
Vailintín	NP-Fam;
Valera	NP-Fam-V;
