LEXICON NP-LEX-PERS
Afraic	Nf2-Prop;
Ailís	Nf2-Prop;
Anastáis	Nf2-Prop;
Aoibeann	Nf2-Prop;
Aoibheann	Nf2-Prop;
Béibhinn	Nf2-Prop;
Bríd	Nf2-Prop;
Caoileann	Nf2-Prop;
Doireann	Nf2-Prop;
Éadaoin	Nf2-Prop;
Eilís	Nf2-Prop;
Glóir	Nf2-Prop;
Laoiseach	Nf2-Prop;
Lil	Nf2-Prop;
Méabh	Nf2-Prop;
!!!Mór	Nf2-Prop; Rare usage as personal name in current times
Muireal	Nf2-Prop;
Muireann	Nf2-Prop;
Niamh	Nf2-Prop;
Richeal	Nf2-Prop;
Ríonach	Nf2-Prop;
Róis	Nf2-Prop;
Sadhbh	Nf2-Prop;
Gormlaith	Nf3-Prop;
Laisrian	Nf3-Prop;
Orlaith	Nf3-Prop;
Ros	Nf3-Prop;
Agata	Nf4-Prop;
Aghna	Nf4-Prop;
Aiche	Nf4-Prop;
Ailbhe	Nf4-Prop;
Ailsíse	Nf4-Prop;
Aimilíona	Nf4-Prop;
Áine	Nf4-Prop;
Aingeal	Nf4-Prop;
Aisling	Nf4-Prop;
Aisún	Nf4-Prop;
Alaidh	Nf4-Prop;
Alastríona	Nf4-Prop;
Alma	Nf4-Prop;
Anna	Nf4-Prop;
Aodhnait	Nf4-Prop;
Aoife	Nf4-Prop;
Aoileann	Nf4-Prop;
Athracht	Nf4-Prop;
Báb	Nf4-Prop;
Baibín	Nf4-Prop;
Bairbre	Nf4-Prop;
!!!!Bean Mhí	Nf4-Prop;
!!!!Bean Mhumhan	Nf4-Prop;
Béatraís	Nf4-Prop;
Bláthnaid	Nf4-Prop;
Brídín	Nf4-Prop;
Cairméal	Nf4-Prop;
Cáit	Nf4-Prop;
Cáitín	Nf4-Prop;
Caitlín	Nf4-Prop;
Caitríona	Nf4-Prop;
Caoilfhionn	Nf4-Prop;
Caoimhe	Nf4-Prop;
Caral	Nf4-Prop;
Cearúilín	Nf4-Prop;
Ceilín	Nf4-Prop;
Cianait	Nf4-Prop;
Ciara	Nf4-Prop;
Cití	Nf4-Prop;
Clár	Nf4-Prop;
Clóda	Nf4-Prop;
Colma	Nf4-Prop;
Córa	Nf4-Prop;
Cráinne	Nf4-Prop;
Cristíona	Nf4-Prop;
Damhnait	Nf4-Prop;
Diána	Nf4-Prop;
Dóirín	Nf4-Prop;
Ealáir	Nf4-Prop;
Earnait	Nf4-Prop;
Eibhfín	Nf4-Prop;
Eibhlín	Nf4-Prop;
Eileanóra	Nf4-Prop;
Eilionóir	Nf4-Prop;
Eilís	Nf4-Prop;
Eimhear	Nf4-Prop;
Eimíle	Nf4-Prop;
Eistir	Nf4-Prop;
Eithne	Nf4-Prop;
Faoiltiarna	Nf4-Prop;
Filimín	Nf4-Prop;
Filis	Nf4-Prop;
Fíonnuala	Nf4-Prop;
Gaibriélle	Nf4-Prop;
Gearóidin	Nf4-Prop;
Gobnait	Nf4-Prop;
Gráinne	Nf4-Prop;
Hilde	Nf4-Prop;
íde	Nf4-Prop;
Imelda	Nf4-Prop;
Isibéal	Nf4-Prop;
Labhaoise	Nf4-Prop;
Lára	Nf4-Prop;
Lasairíona	Nf4-Prop;
Léan	Nf4-Prop;
Lile	Nf4-Prop;
Lorna	Nf4-Prop;
Irial	Nf4-Prop;
Máda	Nf4-Prop;
Madailín	Nf4-Prop;
Máible	Nf4-Prop;
Maighréad	Nf4-Prop;
Máille	Nf4-Prop;
Maim	Nf4-Prop;	! mar 2012
Máire	Nf4-Prop;
Máiréad	Nf4-Prop;
Máirín	Nf4-Prop;
Mairsile	Nf4-Prop;
Maití	Nf4-Prop;
Maitilde	Nf4-Prop;
Marta	Nf4-Prop;
Mealla	Nf4-Prop;
Míde	Nf4-Prop;
Miriam	Nf4-Prop;
Móirín	Nf4-Prop;
Moncha	Nf4-Prop;
Muanait	Nf4-Prop;
Nábla	Nf4-Prop;
Neans	Nf4-Prop;
Neasa	Nf4-Prop;
Neill	Nf4-Prop;
Nóirín	Nf4-Prop;
Nollaig	Nf4-Prop;
Nóra	Nf4-Prop;
Norma	Nf4-Prop;
Nuala	Nf4-Prop;
Oilbhe	Nf4-Prop;
Onóra	Nf4-Prop;
Ornáit	Nf4-Prop;
Pádraigín	Nf4-Prop;
Peig	Nf4-Prop;
Peigí	Nf4-Prop;
Póilín	Nf4-Prop;
Pol	Nf4-Prop;
Rathnait	Nf4-Prop;
Réaltán	Nf4-Prop;
Ríte	Nf4-Prop;
Róise	Nf4-Prop;
Róisín	Nf4-Prop;
Róna	Nf4-Prop;
Rút	Nf4-Prop;
Sadhbh	Nf4-Prop;
Saidhbhín	Nf4-Prop;
Sandra	Nf4-Prop;
Séarlait	Nf4-Prop;
Seoighe	Nf4-Prop;
Seosaimhín	Nf4-Prop;
Sibéal	Nf4-Prop;
Sífe	Nf4-Prop;
Sílbhe	Nf4-Prop;
Síle	Nf4-Prop;
Sinéad	Nf4-Prop;
Siobhán	Nf4-Prop;
Sláine	Nf4-Prop;
Sorcha	Nf4-Prop;
Stáise	Nf4-Prop;
Stiofáinín	Nf4-Prop;
Susanna	Nf4-Prop;
Tilde	Nf4-Prop;
Treasa	Nf4-Prop;
Tríona	Nf4-Prop;
Una	Nf4-Prop;
Úna	Nf4-Prop;
Ursula	Nf4-Prop;
!!!!Giolla Bhearaigh	Nm1-Prop;
Abán	Nm1-Prop;
Ábraham	Nm1-Prop;
Adam	Nm1-Prop;
Adhamhnán	Nm1-Prop;
Aibhistín	Nm1-Prop;
Aindréas	Nm1-Prop;
Alastar	Nm1-Prop;
Albán	Nm1-Prop;
Alfonsas	Nm1-Prop;
Alsandar	Nm1-Prop;
Ambrós	Nm1-Prop;
Anluan	Nm1-Prop;
Aodhán	Nm1-Prop;
Aogán	Nm1-Prop;
Aonas	Nm1-Prop;
Ardal	Nm1-Prop;
Art	Nm1-Prop;
Artúr	Nm1-Prop;
Bairtliméad	Nm1-Prop;
Baolach	Nm1-Prop;
Beacán	Nm1-Prop;
Bearchán	Nm1-Prop;
Bearnard	Nm1-Prop;
Beineán	Nm1-Prop;
Beircheart	Nm1-Prop;
Bran	Nm1-Prop;
Breandán	Nm1-Prop;
Breasal	Nm1-Prop;
Buach	Nm1-Prop;
Cafarr	Nm1-Prop;
Cainneach	Nm1-Prop;
Calbhach	Nm1-Prop;
Caolán	Nm1-Prop;
Caomhán	Nm1-Prop;
Cárthach	Nm1-Prop;
Cathal	Nm1-Prop;
Ceallach	Nm1-Prop;
Ceallachán	Nm1-Prop;
Cearúil	Nm1-Prop;
Ceiteach	Nm1-Prop;
Cianán	Nm1-Prop;
Ciarán	Nm1-Prop;
Coireall	Nm1-Prop;
Colmán	Nm1-Prop;
Comán	Nm1-Prop;
Comhall	Nm1-Prop;
Comhan	Nm1-Prop;
Conall	Nm1-Prop;
Conán	Nm1-Prop;
Conchur	Nm1-Prop;
Conchúr	Nm1-Prop;
Conn	Nm1-Prop;
Cormac	Nm1-Prop;
Criofann	Nm1-Prop;
Cróchán	Nm1-Prop;
Crónán	Nm1-Prop;
Cuan	Nm1-Prop;
Cúchoigrí	Nm1-Prop;
Déaglán	Nm1-Prop;
Deasún	Nm1-Prop;
Dónall	Nm1-Prop;
Donn	Nm1-Prop;
Donnagán	Nm1-Prop;
Donnán	Nm1-Prop;
Donncha	Nm1-Prop;
Dualtach	Nm1-Prop;
Dubhán	Nm1-Prop;
Dúghall	Nm1-Prop;
Dúghlas	Nm1-Prop;
Dubhghlas	Nm1-Prop;
Éadbhard	Nm1-Prop;
Éamann	Nm1-Prop;
Éanán	Nm1-Prop;
Earcán	Nm1-Prop;
Earnán	Nm1-Prop;
Eighneachán	Nm1-Prop;
Éimhear	Nm1-Prop;
Eireamhón	Nm1-Prop;
Eoghan	Nm1-Prop;
Faolán	Nm1-Prop;
Fearach	Nm1-Prop;
Fearal	Nm1-Prop;
Fearghal	Nm1-Prop;
Fearghas	Nm1-Prop;
Fionn	Nm1-Prop;
Fionnán	Nm1-Prop;
Fionnbharr	Nm1-Prop;
Fiontán	Nm1-Prop;
Flann	Nm1-Prop;
Flannán	Nm1-Prop;
Garbhán	Nm1-Prop;
Gearalt	Nm1-Prop;
Gearard	Nm1-Prop;
Geaspar	Nm1-Prop;
Gilleán	Nm1-Prop;
Giobún	Nm1-Prop;
Gordan	Nm1-Prop;
Hoibeard	Nm1-Prop;
Íomhar	Nm1-Prop;
Indiach		Nm1-Prop;	! mar 2012
Labhrás	Nm1-Prop;
Laoiseach	Nm1-Prop;
Leon	Nm1-Prop;
Lionard	Nm1-Prop;
Lomán	Nm1-Prop;
Lonán	Nm1-Prop;
Lorcán	Nm1-Prop;
Lúcás	Nm1-Prop;
Lústás	Nm1-Prop;
Maitias	Nm1-Prop;
Mánas	Nm1-Prop;
Mantán	Nm1-Prop;
Marcas	Nm1-Prop;
Meallán	Nm1-Prop;
Mícheál	Nm1-Prop;
Muireartach	Nm1-Prop;
Muirteartach	Nm1-Prop;
Naomhán	Nm1-Prop;
Naomh	Nm1-Prop;
Neasán	Nm1-Prop;
Niall	Nm1-Prop;
Niallán	Nm1-Prop;
Niocal	Nm1-Prop;
Nioclás	Nm1-Prop;
Odhrán	Nm1-Prop;
Oilibhéar	Nm1-Prop;
Órán	Nm1-Prop;
Oscar	Nm1-Prop;
Parthalán	Nm1-Prop;
Pascal	Nm1-Prop;
Peadar	Nm1-Prop;
Pól	Nm1-Prop;
Ránall	Nm1-Prop;
Rannulbh	Nm1-Prop;
Réamann	Nm1-Prop;
Riocard	Nm1-Prop;
Risteard	Nm1-Prop;
Roibeard	Nm1-Prop;
Rólann	Nm1-Prop;
Rónán	Nm1-Prop;
Ruán	Nm1-Prop;
Saerbhreathach	Nm1-Prop;
Sailbheastar	Nm1-Prop;
Séamas	Nm1-Prop;
Seán	Nm1-Prop;
Seanán	Nm1-Prop;
Séarlas	Nm1-Prop;
Séathrún	Nm1-Prop;
Seosamh	Nm1-Prop;
Sial	Nm1-Prop;
Síomón	Nm1-Prop;
Siseal	Nm1-Prop;
Solamh	Nm1-Prop;
Stiofán	Nm1-Prop;
Tadhg	Nm1-Prop;
Tiarnach	Nm1-Prop;
Tiarnán	Nm1-Prop;
Toirealach	Nm1-Prop;
Tomaltach	Nm1-Prop;
Tomás	Nm1-Prop;
Tuathal	Nm1-Prop;
Ualtar	Nm1-Prop;
Uinseann	Nm1-Prop;
Úistean	Nm1-Prop;
Ultán	Nm1-Prop;
Aodh	Nm3-Prop;
Aonghus	Nm3-Prop;
Connlaodh	Nm3-Prop;
Críostóir	Nm3-Prop;
Diarmaid	Nm3-Prop;
Diarmuid	Nm3-Prop;
Gréagóir	Nm3-Prop;
Iarlaith	Nm3-Prop;
Iarlaith	Nm3-Prop;
Mathúin	Nm3-Prop;
Matha	Nm4-Prop;  ! Mathew?
Meilseoir	Nm3-Prop;
Naos	Nm3-Prop;
Téadóir	Nm3-Prop;
!!!!Giolla Bhríde	Nm4-Prop;
!!!!Giolla Dé	Nm4-Prop;
!!!!Giolla Íosa	Nm4-Prop;
Íosa	Nm4-Prop;
Agaistín	Nm4-Prop;
Aibhistin	Nm4-Prop;
Aibhne	Nm4-Prop;
Aidhleart	Nm4-Prop;
Aidhlmear	Nm4-Prop;
Ailbhe	Nm4-Prop;
Ailéin	Nm4-Prop;
Ailfrid	Nm4-Prop;
Ailín	Nm4-Prop;
Aindriú	Nm4-Prop;
Ainéislis	Nm4-Prop;
Áistín	Nm4-Prop;
Alabhaois	Nm4-Prop;
Amhlaoibh	Nm4-Prop;
Antain	Nm4-Prop;
Antaine	Nm4-Prop;
Aodhán	Nm4-Prop;
Arascain	Nm4-Prop;
Barra	Nm4-Prop;
Beartlaidh	Nm4-Prop;
Beiniaimín	Nm4-Prop;
Beinidict	Nm4-Prop;
Bonaveantúr	Nm4-Prop;
Buach	Nm4-Prop;
Cairbre	Nm4-Prop;
Caoimhín	Nm4-Prop;
Cathair	Nm4-Prop;
Cian	Nm4-Prop;
Cillian	Nm4-Prop;
Cinnéide	Nm4-Prop;
Coilín	Nm4-Prop;
Coimín	Nm4-Prop;
Colla	Nm4-Prop;
Colm	Nm4-Prop;
Conaire	Nm4-Prop;
Consaidín	Nm4-Prop;
!!!!Cú Uladh	Nm4-Prop;
Cuimín	Nm4-Prop;
Cumhaí	Nm4-Prop;
Cúmhaí	Nm4-Prop;
Daibhéid	Nm4-Prop;
Dáire	Nm4-Prop;
Dáithí	Nm4-Prop;
Dioraí	Nm4-Prop;
Doiminic	Nm4-Prop;
Donncha	Nm4-Prop;
Eachaidh	Nm4-Prop;
Éanna	Nm4-Prop;
Eiméid	Nm4-Prop;
Éimhín	Nm4-Prop;
Eirnín	Nm4-Prop;
Eochaidh	Nm4-Prop;
Eoghainín	Nm4-Prop;
Eoin	Nm4-Prop;
!!!!Eoin Baiste	Nm4-Prop;
Fachna	Nm4-Prop;
Fáilbhe	Nm4-Prop;
Feardorcha	Nm4-Prop;
Feichín	Nm4-Prop;
Féilim	Nm4-Prop;
Feilimí	Nm4-Prop;
Fiacha	Nm4-Prop;
Fiachra	Nm4-Prop;
Finín	Nm4-Prop;
Finnian	Nm4-Prop;
Flaithrí	Nm4-Prop;
Frainc	Nm4-Prop;
Fursa	Nm4-Prop;
Gaibriél	Nm4-Prop;
Gearóid	Nm4-Prop;
Gilbeirt	Nm4-Prop;
!!!!Giolla Chríost	Nm4-Prop;
!!!!Giolla Easpaig	Nm4-Prop;
!!!!Giolla na Naomh	Nm4-Prop;
Glaisne	Nm4-Prop;
Gothraidh	Nm4-Prop;
Haol	Nm4-Prop;
Íácób	Nm4-Prop;
íosóg	Nm4-Prop;
Laimbeart	Nm4-Prop;
Leaslaoi	Nm4-Prop;
Liam	Nm4-Prop;
Lochlainn	Nm4-Prop;
Lughaidh	Nm4-Prop;
iúil	Nm4-Prop;
Mainchín	Nm4-Prop;
Máirtín	Nm4-Prop;
Mait	Nm4-Prop;
Maitiú	Nm4-Prop;
Maodhóg	Nm4-Prop;
Maoileachlainn	Nm4-Prop;
Maoilíosa	Nm4-Prop;
Maoilir	Nm4-Prop;
Maolcholaim	Nm4-Prop;
Maolmhuire	Nm4-Prop;
Maolruáin	Nm4-Prop;
Muireách	Nm4-Prop;
Muirí	Nm4-Prop;
Muiris	Nm4-Prop;
Murcha	Nm4-Prop;
Naoise	Nm4-Prop;
Nollaig	Nm4-Prop;
Oisín	Nm4-Prop;
Pádraig	Nm4-Prop;
Páid	Nm4-Prop;
Páidín	Nm4-Prop;
Piaras	Nm4-Prop;
Pilib	Nm4-Prop;
Píus	Nm4-Prop;
Proinsias	Nm4-Prop;
Raibhilín	Nm4-Prop;
Raphael	Nm4-Prop;
Ráulbh	Nm4-Prop;
Roibín	Nm4-Prop;
Ruairí	Nm4-Prop;
Séafra	Nm4-Prop;
Séanna	Nm4-Prop;
Séathra	Nm4-Prop;
Séimí	Nm4-Prop;
Seoirse	Nm4-Prop;
Somhairle	Nm4-Prop;
Suibhne	Nm4-Prop;
Taidhgín	Nm4-Prop;
Tiobóid	Nm4-Prop;
Uaine	Nm4-Prop;
Úgaine	Nm4-Prop;
Uileag	Nm4-Prop;
Uilfrid	Nm4-Prop;
Vail	Nm4-Prop;
Vailintín	Nm4-Prop;
Punk		Nm4-Prop;
Rex		Nm4-Prop;
Eiffel		Nm4-Prop;
Daid		Nm4-Prop;

