LEXICON NP-LEX-PERS-EN
Abaham	NP-PERS-EN;
Abban	NP-PERS-EN;
Abbie	NP-PERS-EN-fem;
Abigail	NP-PERS-EN-fem;
Abina	NP-PERS-EN-fem;
Adam	NP-PERS-EN;
Adelard	NP-PERS-EN;
Aedan	NP-PERS-EN;
Aeneas	NP-PERS-EN;
Affy	NP-PERS-EN;
Afric	NP-PERS-EN-fem;
Agatha	NP-PERS-EN-fem;
Aghy	NP-PERS-EN;
Agnes	NP-PERS-EN-fem;
Aidan	NP-PERS-EN;
Aideen	NP-PERS-EN-fem;
Aileen	NP-PERS-EN-fem;
Aisling	NP-PERS-EN-fem;
Alan	NP-PERS-EN;
Alastrina	NP-PERS-EN-fem;
Alban	NP-PERS-EN;
Albert	NP-PERS-EN;
Alby	NP-PERS-EN;
Alex	NP-PERS-EN;
Alexander	NP-PERS-EN;
Alexandra	NP-PERS-EN-fem;
Alfons	NP-PERS-EN;
Alfred	NP-PERS-EN;
Alice	NP-PERS-EN-fem;
Alick	NP-PERS-EN;
Allen	NP-PERS-EN;
Alley	NP-PERS-EN-fem;
Allison	NP-PERS-EN-fem;
Allister	NP-PERS-EN;
Alma	NP-PERS-EN-fem;
Aloysius	NP-PERS-EN;
Alphonsus	NP-PERS-EN;
Alvy	NP-PERS-EN;
Ambrose	NP-PERS-EN;
Ameliona	NP-PERS-EN-fem;
Anastasia	NP-PERS-EN-fem;
Andreas	NP-PERS-EN;
Andrew	NP-PERS-EN;
Aneaslis	NP-PERS-EN;
Aneslis	NP-PERS-EN;
Angela	NP-PERS-EN-fem;
Angus	NP-PERS-EN;
Anlon	NP-PERS-EN;
Anna	NP-PERS-EN-fem;
Annabel	NP-PERS-EN-fem;
Annabella	NP-PERS-EN-fem;
Anne	NP-PERS-EN-fem;
Annie	NP-PERS-EN-fem;
Anthin	NP-PERS-EN;
Anthony	NP-PERS-EN;
Aoileann	NP-PERS-EN-fem;
Aonghus	NP-PERS-EN;
Arabella	NP-PERS-EN-fem;
Archibald	NP-PERS-EN;
Ardal	NP-PERS-EN;
Arnold	NP-PERS-EN;
Art	NP-PERS-EN;
Arthur	NP-PERS-EN;
Attracta	NP-PERS-EN-fem;
Atty	NP-PERS-EN;
Augustin	NP-PERS-EN;
Auliffe	NP-PERS-EN;
Austin	NP-PERS-EN;
Avvy	NP-PERS-EN;
Bab	NP-PERS-EN-fem;
Babe	NP-PERS-EN-fem;
Barbara	NP-PERS-EN-fem;
Barclay	NP-PERS-EN;
Barnaby	NP-PERS-EN;
Barney	NP-PERS-EN;
Barry	NP-PERS-EN;
Bartlemy	NP-PERS-EN;
Bartley	NP-PERS-EN;
Basil	NP-PERS-EN;
Batt	NP-PERS-EN;
Beatrice	NP-PERS-EN-fem;
Becan	NP-PERS-EN;
Bella	NP-PERS-EN-fem;
Ben	NP-PERS-EN;
Benedict	NP-PERS-EN;
Benen	NP-PERS-EN;
Benignus	NP-PERS-EN;
Benjamin	NP-PERS-EN;
Benvon	NP-PERS-EN;
Benvy	NP-PERS-EN;
Bercan	NP-PERS-EN;
Berkley	NP-PERS-EN;
Bernard	NP-PERS-EN;
Bertie	NP-PERS-EN;
Bessy	NP-PERS-EN-fem;
Blanaid	NP-PERS-EN-fem;
Boetius	NP-PERS-EN;
Bonaventure	NP-PERS-EN;
Bowes	NP-PERS-EN;
Bran	NP-PERS-EN;
Brasil	NP-PERS-EN;
Breege	NP-PERS-EN-fem;
Breegeen	NP-PERS-EN-fem;
Brendan	NP-PERS-EN;
Brian	NP-PERS-EN;
Buagh	NP-PERS-EN;
Caffar	NP-PERS-EN;
Cahal	NP-PERS-EN;
Cahir	NP-PERS-EN;
Callaghan	NP-PERS-EN;
Cain	NP-PERS-EN;
Calvach	NP-PERS-EN;
Canice	NP-PERS-EN;
Caoilfhionn	NP-PERS-EN-fem;
Carbry	NP-PERS-EN;
Carmel	NP-PERS-EN-fem;
Carol	NP-PERS-EN-fem;
Caroline	NP-PERS-EN-fem;
Carroll	NP-PERS-EN;
Cartagh	NP-PERS-EN;
Catherine	NP-PERS-EN-fem;
Catriona	NP-PERS-EN-fem;
Cecelia	NP-PERS-EN-fem;
Cecil	NP-PERS-EN;
Celene	NP-PERS-EN-fem;
Celsus	NP-PERS-EN;
Charles	NP-PERS-EN;
Charlotte	NP-PERS-EN-fem;
Christian	NP-PERS-EN;
Christina	NP-PERS-EN-fem;
Christopher	NP-PERS-EN;
Clara	NP-PERS-EN-fem;
Clare	NP-PERS-EN-fem;
Cloda	NP-PERS-EN-fem;
Cole	NP-PERS-EN;
Colin	NP-PERS-EN;
Colla	NP-PERS-EN-fem;
Colleen	NP-PERS-EN-fem;
Colm	NP-PERS-EN;
Colma	NP-PERS-EN-fem;
Colman	NP-PERS-EN;
Coman	NP-PERS-EN;
Comyn	NP-PERS-EN;
Con	NP-PERS-EN;
Conall	NP-PERS-EN;
Conan	NP-PERS-EN;
Conary	NP-PERS-EN;
Conleth	NP-PERS-EN;
Conn	NP-PERS-EN;
Connor	NP-PERS-EN;
Constantine	NP-PERS-EN;
Cooey	NP-PERS-EN;
Cora	NP-PERS-EN-fem;
Cormac	NP-PERS-EN;
Cornelius	NP-PERS-EN;
Cowan	NP-PERS-EN;
Crevan	NP-PERS-EN;
Crohan	NP-PERS-EN;
Cronan	NP-PERS-EN;
Cuan	NP-PERS-EN;
Cullo	NP-PERS-EN;
Cumin	NP-PERS-EN;
Cyril	NP-PERS-EN;
Dahy	NP-PERS-EN;
Daniel	NP-PERS-EN;
Darby	NP-PERS-EN;
Dary	NP-PERS-EN;
David	NP-PERS-EN;
Davy	NP-PERS-EN;
Declan	NP-PERS-EN;
Denis	NP-PERS-EN;
Dermod	NP-PERS-EN;
Dermot	NP-PERS-EN;
Derry	NP-PERS-EN;
Desmond	NP-PERS-EN;
Diana	NP-PERS-EN-fem;
Dillie	NP-PERS-EN-fem;
Dina	NP-PERS-EN-fem;
Dolly	NP-PERS-EN-fem;
Dominic	NP-PERS-EN;
Dominick	NP-PERS-EN;
Don	NP-PERS-EN;
Donaghy	NP-PERS-EN;
Donal	NP-PERS-EN;
Donald	NP-PERS-EN;
Donall	NP-PERS-EN;
Donat	NP-PERS-EN;
Donnan	NP-PERS-EN;
Donogh	NP-PERS-EN;
Doreen	NP-PERS-EN-fem;
Dorothy	NP-PERS-EN-fem;
Douglas	NP-PERS-EN;
Dowan	NP-PERS-EN;
Duald	NP-PERS-EN;
Dualtagh	NP-PERS-EN;
Dudley	NP-PERS-EN;
Dugald	NP-PERS-EN;
Duncan	NP-PERS-EN;
Duncán	NP-PERS-EN;
Dymphna	NP-PERS-EN-fem;
Eamon	NP-PERS-EN;
Eavan	NP-PERS-EN;
Eber	NP-PERS-EN;
Edan	NP-PERS-EN;
Eddie	NP-PERS-EN;
Edmond	NP-PERS-EN;
Edward	NP-PERS-EN;
Edwina	NP-PERS-EN-fem;
Egan	NP-PERS-EN;
Eileen	NP-PERS-EN-fem;
Eilis	NP-PERS-EN-fem;
Eisha	NP-PERS-EN;
Eithne	NP-PERS-EN-fem;
Elaine	NP-PERS-EN-fem;
Eleanor	NP-PERS-EN-fem;
Eleanora	NP-PERS-EN-fem;
Eliza	NP-PERS-EN-fem;
Elizabeth	NP-PERS-EN-fem;
Ellen	NP-PERS-EN-fem;
Elmer	NP-PERS-EN;
Elva	NP-PERS-EN-fem;
Emer	NP-PERS-EN-fem;
Emily	NP-PERS-EN-fem;
Emmet	NP-PERS-EN;
Ena	NP-PERS-EN-fem;
Enan	NP-PERS-EN;
Enda	NP-PERS-EN;
Eneas	NP-PERS-EN;
Eny	NP-PERS-EN;
Eoghan	NP-PERS-EN;
Eoin	NP-PERS-EN;
Ercan	NP-PERS-EN;
Erevan	NP-PERS-EN;
Ernan	NP-PERS-EN;
Ernest	NP-PERS-EN;
Ernet	NP-PERS-EN;
Ernin	NP-PERS-EN;
Erskine	NP-PERS-EN;
Esther	NP-PERS-EN-fem;
Ethna	NP-PERS-EN-fem;
Eugene	NP-PERS-EN;
Eunan	NP-PERS-EN;
Eustace	NP-PERS-EN;
Euston	NP-PERS-EN;
Eva	NP-PERS-EN-fem;
Eveleen	NP-PERS-EN-fem;
Eveny	NP-PERS-EN;
Ever	NP-PERS-EN;
Evin	NP-PERS-EN;
Fachnan	NP-PERS-EN;
Falvy	NP-PERS-EN;
Farrell	NP-PERS-EN;
Farry	NP-PERS-EN;
Feagh	NP-PERS-EN;
Feary	NP-PERS-EN;
Fehin	NP-PERS-EN;
Felan	NP-PERS-EN;
Felim	NP-PERS-EN;
Felimy	NP-PERS-EN;
Felix	NP-PERS-EN;
Ferdinand	NP-PERS-EN;
Fergal	NP-PERS-EN;
Fergus	NP-PERS-EN;
Festus	NP-PERS-EN;
Fiachra	NP-PERS-EN;
Finan	NP-PERS-EN;
Finbar	NP-PERS-EN;
Fineen	NP-PERS-EN;
Finian	NP-PERS-EN;
Finn	NP-PERS-EN;
Fintan	NP-PERS-EN;
Fionan	NP-PERS-EN;
Flan	NP-PERS-EN;
Flanan	NP-PERS-EN;
Florence	NP-PERS-EN-fem;
Florrie	NP-PERS-EN-fem;
Francis	NP-PERS-EN;
Frank	NP-PERS-EN;
Frederick	NP-PERS-EN;
Fursey	NP-PERS-EN;
Gabriel	NP-PERS-EN;
Gabrielle	NP-PERS-EN-fem;
Garrett	NP-PERS-EN;
Garvan	NP-PERS-EN;
Gay	NP-PERS-EN;
Geoffrey	NP-PERS-EN;
George	NP-PERS-EN;
Gerald	NP-PERS-EN;
Geraldine	NP-PERS-EN-fem;
Gerard	NP-PERS-EN;
Gertie	NP-PERS-EN-fem;
Gertrude	NP-PERS-EN-fem;
Gibbon	NP-PERS-EN;
Gilbert	NP-PERS-EN;
Gilbride	NP-PERS-EN;
Gildea	NP-PERS-EN;
Gillesa	NP-PERS-EN;
Gilvarry	NP-PERS-EN;
Glasney	NP-PERS-EN;
Gloria	NP-PERS-EN-fem;
Gobnet	NP-PERS-EN-fem;
Godfrey	NP-PERS-EN;
Gordan	NP-PERS-EN;
Gormlaith	NP-PERS-EN-fem;
Gorry	NP-PERS-EN;
Grace	NP-PERS-EN-fem;
Gregory	NP-PERS-EN;
Hannah	NP-PERS-EN-fem;
Helen	NP-PERS-EN-fem;
Héléne	NP-PERS-EN-fem;
Hilary	NP-PERS-EN-fem;
Hilda	NP-PERS-EN-fem;
Hildy	NP-PERS-EN-fem;
Honor	NP-PERS-EN-fem;
Honora	NP-PERS-EN-fem;
Howel	NP-PERS-EN;
Hubert	NP-PERS-EN;
Hugh	NP-PERS-EN;
Hugony	NP-PERS-EN;
Humphrey	NP-PERS-EN;
Iarla	NP-PERS-EN;
Ida	NP-PERS-EN-fem;
Ignatius	NP-PERS-EN;
Imelda	NP-PERS-EN-fem;
!!Ina	NP-PERS-EN-fem;		! clashes with prep-pron etc
Irving	NP-PERS-EN;
Isaac	NP-PERS-EN;
Isabella	NP-PERS-EN-fem;
Ita	NP-PERS-EN-fem;
Ivor	NP-PERS-EN;
Jacob	NP-PERS-EN;
James	NP-PERS-EN;
Jane	NP-PERS-EN-fem;
Jannet	NP-PERS-EN-fem;
Jarlath	NP-PERS-EN;
Jarmy	NP-PERS-EN;
Jasper	NP-PERS-EN;
Jeffrey	NP-PERS-EN;
Jenny	NP-PERS-EN-fem;
Jeremiah	NP-PERS-EN;
Jerome	NP-PERS-EN;
Jerry	NP-PERS-EN;
Jimmy	NP-PERS-EN;
Joan	NP-PERS-EN-fem;
Johanna	NP-PERS-EN-fem;
John	NP-PERS-EN;
!!!!John Baptist	NP-PERS-EN;
Joseph	NP-PERS-EN;
Josephine	NP-PERS-EN-fem;
Joy	NP-PERS-EN-fem;
Joyce	NP-PERS-EN-fem;
Jude	NP-PERS-EN-fem;
Judith	NP-PERS-EN-fem;
Julia	NP-PERS-EN-fem;
Julian	NP-PERS-EN;
Julie	NP-PERS-EN-fem;
Julius	NP-PERS-EN;
Justin	NP-PERS-EN;
Kate	NP-PERS-EN-fem;
Kathleen	NP-PERS-EN-fem;
Katie	NP-PERS-EN-fem;
Kealan	NP-PERS-EN-fem;
Kean	NP-PERS-EN;
Keavy	NP-PERS-EN;
Keelin	NP-PERS-EN-fem;
Keenet	NP-PERS-EN;
Keith	NP-PERS-EN;
Kellagh	NP-PERS-EN;
Kenan	NP-PERS-EN;
Kenny	NP-PERS-EN;
Kerill	NP-PERS-EN;
Kevan	NP-PERS-EN;
Kevin	NP-PERS-EN;
Kian	NP-PERS-EN;
Kienan	NP-PERS-EN;
Kieran	NP-PERS-EN;
Killian	NP-PERS-EN;
Kyra	NP-PERS-EN-fem;
Lambert	NP-PERS-EN;
Ian	NP-PERS-EN;
Lasarina	NP-PERS-EN-fem;
Laserian	NP-PERS-EN-fem;
Laughlin	NP-PERS-EN;
Laura	NP-PERS-EN-fem;
Laurence	NP-PERS-EN;
Lelia	NP-PERS-EN-fem;
!!! ambig with prep "lena" Lena	NP-PERS-EN-fem;
Leo	NP-PERS-EN;
Leonard	NP-PERS-EN;
Leslie	NP-PERS-EN;
Lewis	NP-PERS-EN;
Lewy	NP-PERS-EN;
Lil	NP-PERS-EN-fem;
Lile	NP-PERS-EN-fem;
Lizzie	NP-PERS-EN-fem;
Loman	NP-PERS-EN;
Lonan	NP-PERS-EN;
Lorcan	NP-PERS-EN;
Lorna	NP-PERS-EN-fem;
Louisa	NP-PERS-EN-fem;
Irial	NP-PERS-EN;
Lucius	NP-PERS-EN;
Lucy	NP-PERS-EN-fem;
Luke	NP-PERS-EN;
Lysagh	NP-PERS-EN;
Mabbina	NP-PERS-EN-fem;
Mabel	NP-PERS-EN-fem;
Madeline	NP-PERS-EN-fem;
Madge	NP-PERS-EN-fem;
Maelisa	NP-PERS-EN-fem;
Maeve	NP-PERS-EN-fem;
Mahon	NP-PERS-EN;
Mairead	NP-PERS-EN-fem;
Malachy	NP-PERS-EN;
Malcolm	NP-PERS-EN;
Manasses	NP-PERS-EN;
Mannix	NP-PERS-EN;
Mantan	NP-PERS-EN;
Manus	NP-PERS-EN;
Marcas	NP-PERS-EN;
Marcella	NP-PERS-EN-fem;
Margaret	NP-PERS-EN-fem;
Margery	NP-PERS-EN-fem;
Maria	NP-PERS-EN-fem;
Marion	NP-PERS-EN-fem;
Marjory	NP-PERS-EN-fem;
Mark	NP-PERS-EN;
Martha	NP-PERS-EN-fem;
Martin	NP-PERS-EN;
Mary	NP-PERS-EN-fem;
Mat	NP-PERS-EN;
Matilda	NP-PERS-EN-fem;
Matthew	NP-PERS-EN;
Matthias	NP-PERS-EN;
Matty	NP-PERS-EN;
Maureen	NP-PERS-EN-fem;
Maurice	NP-PERS-EN;
Mawd	NP-PERS-EN-fem;
Maud	NP-PERS-EN-fem;
May	NP-PERS-EN-fem;
Meeda	NP-PERS-EN-fem;
Melaghlin	NP-PERS-EN;
Melchor	NP-PERS-EN;
Meldan	NP-PERS-EN;
Mella	NP-PERS-EN-fem;
Mellan	NP-PERS-EN;
Melrone	NP-PERS-EN;
Michael	NP-PERS-EN;
Miriam	NP-PERS-EN-fem;
Moira	NP-PERS-EN-fem;
Molly	NP-PERS-EN-fem;
Mona	NP-PERS-EN-fem;
Monica	NP-PERS-EN-fem;
More	NP-PERS-EN-fem;
Moreen	NP-PERS-EN-fem;
Morgan	NP-PERS-EN;
Morgue	NP-PERS-EN;
Morrin	NP-PERS-EN-fem;
Mortimer	NP-PERS-EN;
Moses	NP-PERS-EN;
Muirdeach	NP-PERS-EN-fem;
Munchin	NP-PERS-EN;
Mundy	NP-PERS-EN;
Muriel	NP-PERS-EN-fem;
Murrough	NP-PERS-EN;
Murry	NP-PERS-EN;
Murtough	NP-PERS-EN;
Myler	NP-PERS-EN;
Myles	NP-PERS-EN;
Nabla	NP-PERS-EN;
Nan	NP-PERS-EN-fem;
Nance	NP-PERS-EN-fem;
Nanno	NP-PERS-EN-fem;
Naoise	NP-PERS-EN;
Nappy	NP-PERS-EN;
Naugher	NP-PERS-EN;
Neal	NP-PERS-EN;
Neale	NP-PERS-EN;
Neece	NP-PERS-EN;
Neeve	NP-PERS-EN-fem;
Nehemiah	NP-PERS-EN;
Neli	NP-PERS-EN-fem;
Nessa	NP-PERS-EN-fem;
Nessan	NP-PERS-EN;
Nevan	NP-PERS-EN;
Niall	NP-PERS-EN;
Niallan	NP-PERS-EN;
Nicholas	NP-PERS-EN;
Nicol	NP-PERS-EN;
Niece	NP-PERS-EN;
Noel	NP-PERS-EN;
Noelle	NP-PERS-EN-fem;
Nonie	NP-PERS-EN-fem;
Nora	NP-PERS-EN-fem;
Norah	NP-PERS-EN-fem;
Norma	NP-PERS-EN-fem;
Nuala	NP-PERS-EN-fem;
Oghie	NP-PERS-EN;
Oisin	NP-PERS-EN;
Olave	NP-PERS-EN;
Olive	NP-PERS-EN-fem;
Oliver	NP-PERS-EN;
Oney	NP-PERS-EN;
Oona	NP-PERS-EN-fem;
Oran	NP-PERS-EN;
Orlaith	NP-PERS-EN-fem;
Orna	NP-PERS-EN-fem;
Ornat	NP-PERS-EN-fem;
Oscar	NP-PERS-EN;
Ossian	NP-PERS-EN;
Otteran	NP-PERS-EN;
Quintin	NP-PERS-EN;
Owen	NP-PERS-EN;
Owney	NP-PERS-EN;
Padden	NP-PERS-EN;
Paddy	NP-PERS-EN;
Parlan	NP-PERS-EN;
Pascal	NP-PERS-EN;
Pat	NP-PERS-EN;
Patricia	NP-PERS-EN-fem;
Patrick	NP-PERS-EN;
Paul	NP-PERS-EN;
Pauline	NP-PERS-EN-fem;
Peg	NP-PERS-EN-fem;
Peggy	NP-PERS-EN-fem;
Penelope	NP-PERS-EN-fem;
Penny	NP-PERS-EN-fem;
Peregrine	NP-PERS-EN;
Peter	NP-PERS-EN;
Phelim	NP-PERS-EN;
Phelimy	NP-PERS-EN;
Philip	NP-PERS-EN;
Philomena	NP-PERS-EN-fem;
Phylis	NP-PERS-EN-fem;
Pierce	NP-PERS-EN;
Pius	NP-PERS-EN;
Poll	NP-PERS-EN-fem;
Raisin	NP-PERS-EN;
Ralph	NP-PERS-EN;
Rona	NP-PERS-EN-fem;
Randal	NP-PERS-EN;
Randolph	NP-PERS-EN;
Raphael	NP-PERS-EN;
Rosaleen	NP-PERS-EN-fem;
Rose	NP-PERS-EN-fem;
Rosie	NP-PERS-EN-fem;
Raymond	NP-PERS-EN;
Regina	NP-PERS-EN-fem;
Reginald	NP-PERS-EN;
Renny	NP-PERS-EN;
Revelin	NP-PERS-EN;
Richard	NP-PERS-EN;
Richella	NP-PERS-EN-fem;
Rickard	NP-PERS-EN;
Rita	NP-PERS-EN-fem;
Robert	NP-PERS-EN;
Robin	NP-PERS-EN;
Roddy	NP-PERS-EN;
Roderick	NP-PERS-EN;
Roland	NP-PERS-EN;
Ronald	NP-PERS-EN;
Ronan	NP-PERS-EN;
Rory	NP-PERS-EN;
Ros	NP-PERS-EN-fem;
Rowan	NP-PERS-EN;
Rowland	NP-PERS-EN;
Ruth	NP-PERS-EN-fem;
Sabia	NP-PERS-EN-fem;
Sabina	NP-PERS-EN-fem;
Sally	NP-PERS-EN-fem;
Samuel	NP-PERS-EN;
Sandra	NP-PERS-EN-fem;
Sarah	NP-PERS-EN-fem;
Senan	NP-PERS-EN;
Shane	NP-PERS-EN;
Sheary	NP-PERS-EN;
Sheila	NP-PERS-EN-fem;
Sheamas	NP-PERS-EN;
Sharon	NP-PERS-EN-fem;
Shiel	NP-PERS-EN;
Sibby	NP-PERS-EN-fem;
Sidney	NP-PERS-EN;
Simon	NP-PERS-EN;
Sisile	NP-PERS-EN-fem;
Sive	NP-PERS-EN-fem;
Sivney	NP-PERS-EN-fem;
Slany	NP-PERS-EN;
Soloman	NP-PERS-EN;
Sophia	NP-PERS-EN-fem;
Sorley	NP-PERS-EN;
Standish	NP-PERS-EN;
Stanislaus	NP-PERS-EN;
Stasia	NP-PERS-EN-fem;
Stella	NP-PERS-EN-fem;
Stephanie	NP-PERS-EN-fem;
Stephen	NP-PERS-EN;
Susan	NP-PERS-EN-fem;
Susanna	NP-PERS-EN-fem;
Sybil	NP-PERS-EN-fem;
Sylvester	NP-PERS-EN;
Sylvia	NP-PERS-EN-fem;
Synan	NP-PERS-EN;
Tarlagh	NP-PERS-EN;
Teague	NP-PERS-EN;
Teresa	NP-PERS-EN-fem;
Terrence	NP-PERS-EN;
Tessie	NP-PERS-EN-fem;
Thaddeus	NP-PERS-EN;
Theobald	NP-PERS-EN;
Theodore	NP-PERS-EN;
Thomas	NP-PERS-EN;
Tibbot	NP-PERS-EN;
Tiernan	NP-PERS-EN;
Tierney	NP-PERS-EN;
Tilda	NP-PERS-EN-fem;
Tim	NP-PERS-EN;
Timothy	NP-PERS-EN;
Toal	NP-PERS-EN;
Tobias	NP-PERS-EN;
Tomaltagh	NP-PERS-EN;
Tina	NP-PERS-EN-fem;
Triona	NP-PERS-EN-fem;
Turlough	NP-PERS-EN;
Ulick	NP-PERS-EN;
Ultan	NP-PERS-EN;
Ulysses	NP-PERS-EN;
Una	NP-PERS-EN-fem;
Unity	NP-PERS-EN-fem;
Ursula	NP-PERS-EN-fem;
Val	NP-PERS-EN;
Valentine	NP-PERS-EN;
Victor	NP-PERS-EN;
Vincent	NP-PERS-EN;
Vivian	NP-PERS-EN-fem;
Walter	NP-PERS-EN;
Webbie	NP-PERS-EN;
Whiltierna	NP-PERS-EN-fem;
Wilfrid	NP-PERS-EN-fem;
William	NP-PERS-EN;
Winifred	NP-PERS-EN-fem;
Winnie	NP-PERS-EN-fem;
Yvonne	NP-PERS-EN-fem;

!! Added. Most popular names.
!! Male

Aaron	NP-PERS-EN;
Brandon	NP-PERS-EN;
Callum	NP-PERS-EN;
Cameron	NP-PERS-EN;
Cian	NP-PERS-EN;
Ciaran	NP-PERS-EN;
Cillian	NP-PERS-EN;
Daragh	NP-PERS-EN;
Darragh	NP-PERS-EN;
Darren	NP-PERS-EN;
Dean	NP-PERS-EN;
Dillon	NP-PERS-EN;
Dylan	NP-PERS-EN;
Eric	NP-PERS-EN;
Ethan	NP-PERS-EN;
Evan	NP-PERS-EN;
Fionn	NP-PERS-EN;
Gary	NP-PERS-EN;
Gavin	NP-PERS-EN;
Harry	NP-PERS-EN;
Jack	NP-PERS-EN;
Jake	NP-PERS-EN;
Jamie	NP-PERS-EN;
Jason	NP-PERS-EN;
Jonathan	NP-PERS-EN;
Jordan	NP-PERS-EN;
Joshua	NP-PERS-EN;
Karl	NP-PERS-EN;
Kyle	NP-PERS-EN;
Lee	NP-PERS-EN;
Leon	NP-PERS-EN;
Liam	NP-PERS-EN;
Nathan	NP-PERS-EN;
Neil	NP-PERS-EN;
Padraig	NP-PERS-EN;
Reece	NP-PERS-EN;
Ross	NP-PERS-EN;
Ryan	NP-PERS-EN;
Sam	NP-PERS-EN;
Scott	NP-PERS-EN;
Sean	NP-PERS-EN;
Shaun	NP-PERS-EN;

!! Female

Aimee	NP-PERS-EN-fem;
Ashling	NP-PERS-EN-fem;
Alanna	NP-PERS-EN-fem;
Alannah	NP-PERS-EN-fem;
Alison	NP-PERS-EN-fem;
Allana	NP-PERS-EN-fem;
Amy	NP-PERS-EN-fem;
Andrea	NP-PERS-EN-fem;
Ava	NP-PERS-EN-fem;
Caitlin	NP-PERS-EN-fem;
Chelsea	NP-PERS-EN-fem;
Chloe	NP-PERS-EN-fem;
Ciara	NP-PERS-EN-fem;
Claire	NP-PERS-EN-fem;
Clodagh	NP-PERS-EN-fem;
Courtney	NP-PERS-EN-fem;
Danielle	NP-PERS-EN-fem;
Eimear	NP-PERS-EN-fem;
Ella	NP-PERS-EN-fem;
Emma	NP-PERS-EN-fem;
Erin	NP-PERS-EN-fem;
Eve	NP-PERS-EN-fem;
Fiona	NP-PERS-EN-fem;
Gemma	NP-PERS-EN-fem;
Georgia	NP-PERS-EN-fem;
Grainne	NP-PERS-EN-fem;
Holly	NP-PERS-EN-fem;
Isobel	NP-PERS-EN-fem;
Jade	NP-PERS-EN-fem;
Jennifer	NP-PERS-EN-fem;
Jessica	NP-PERS-EN-fem;
Jodie	NP-PERS-EN-fem;
Karen	NP-PERS-EN-fem;
Katelyn	NP-PERS-EN-fem;
Kayleigh	NP-PERS-EN-fem;
Kelly	NP-PERS-EN-fem;
Lauren	NP-PERS-EN-fem;
Lauryn	NP-PERS-EN-fem;
Leah	NP-PERS-EN-fem;
Leanne	NP-PERS-EN-fem;
Lisa	NP-PERS-EN-fem;
Louise	NP-PERS-EN-fem;
Megan	NP-PERS-EN-fem;
Melissa	NP-PERS-EN-fem;
Michaela	NP-PERS-EN-fem;
Michelle	NP-PERS-EN-fem;
Natasha	NP-PERS-EN-fem;
Niamh	NP-PERS-EN-fem;
Nicola	NP-PERS-EN-fem;
Nicole	NP-PERS-EN-fem;
Olivia	NP-PERS-EN-fem;
Rachael	NP-PERS-EN-fem;
Rachel	NP-PERS-EN-fem;
Rebecca	NP-PERS-EN-fem;
Robyn	NP-PERS-EN-fem;
Roisin	NP-PERS-EN-fem;
Saoirse	NP-PERS-EN-fem;
Shannon	NP-PERS-EN-fem;
Shauna	NP-PERS-EN-fem;
Sinead	NP-PERS-EN-fem;
Siobhan	NP-PERS-EN-fem;
Sophie	NP-PERS-EN-fem;
Sorcha	NP-PERS-EN-fem;
Tara	NP-PERS-EN-fem;
Victoria	NP-PERS-EN-fem;
Zoe	NP-PERS-EN-fem;

