LEXICON NP-LEX-TIR
!! no because Na hAfraice Láir/Theas etc ..<A f r a i c %_:%  T h e a s>	Nf2-Prop;	! !!!!South Africa
<B a i l e %_:%  A t h a %_:%  C l i a t h>	Nm4-Prop;	! Dublin
<B é a l %_:%  F e i r s t e>	Nm4-Prop;	! Belfast
<A n %_:%  N í l>	Nf2-Prop;	! Nile
Abcáis	Nf2-Prop;	! Abkhazia
Aeigéach	NP-PLACE-sg;	! !!!!Aegean (Sea)
Aetóip	Nf2-Prop;	! Ethiopia
Afganastáin	Nf2-Prop;	! Afghanistan
Afraic	Nf2-Prop;	! Africa
Aibisín	Nf2-Prop;	! Abyssinia
Áidin	Nf4-Prop;	! Aden
Aidriad	NP-PLACE-sg;	! !!!!Adriatic (Sea)
Aigéine	Nf4-Prop;	! Oceania
Ailgéir	Nf2-Prop;	! Algeria
Airgintín	Nf2-Prop;	! Argentina
Airméin	Nf2-Prop;	! Armenia
Aise	NP-PLACE-sg;	! !!!!Asia Minor
Aíse	Nf4-Prop;	! Asia
Aisiria	Nf4-Prop;	! Assyria
Aithin	Nf2-Prop;	! Athens
Alasca	Nm4-Prop;	! Alaska
Albáin	Nf2-Prop;	! Albania
Albain	Nf5-Prop;	! Scotland
Alsáis	Nf2-Prop;	! Alsace
Amasóin	Nf2-Prop;	! Amazon
Amstardam	Nm4-Prop;	! Amsterdam
Andóra	Nm4-Prop;	! Andorra
Angóla	Nm4-Prop;	! Angola
Antartaice	Nf4-Prop;	! Antarctica
Antuairp	Nf4-Prop;	! Antwerp
Éimíríochtaí	NP-PLACE-pl;	! !!!!United Arab Emirates - Aontas na nÉimíríochtaí Arabacha
Arabacha	AdjM-Prop-pl;	! !!!!United Arab Emirates
Sóivéadach	Nm1-Prop;	! Soviet Union - Aontas na Sóivéadach
Araib	Nf2-Prop;	! Arabia
Shádach	AdjF-Prop;	! !!!!Saudi Arabia
Árainn	NP-PLACE-sg;	! Arainn 
Asarbaiseáin	Nf2-Prop;	! Azerbaijan
Astracáin	Nf2-Prop;	! Astrak(h)an
Astráil	Nf2-Prop;	! Australia
Astraláise	Nf4-Prop;	! Australasia
Bahámaí	NP-PLACE-pl;	! !!!!Bahamas (The )
Bairéin	Nf4-Prop;	! Bahrein
Balcáin	NP-PLACE-pl;	! Balkans
Balúcastáin	Nf2-Prop;	! Baluchistan
Banglaidéis	Nf2-Prop;	! Bangladesh
Barbadós	Nm4-Prop;	! Barbados
Basútlainn	Nf2-Prop;	! Basutoland
Baváir	Nf2-Prop;	! Bavaria
Bioscáin	Nf2-Prop;	!!!!Bá na Bioscáine! !!!!Biscay (Bayof )
Beachuanlainn	Nf2-Prop;	! Bechuanaland
Béalgrád	Nm4-Prop;	! Belgrade
Beangál	Nm4-Prop;	! Bengal
Beilg	Nf2-Prop;	! Belgium
Beilís	Nf2-Prop;	! Belize
Beinin	Nf4-Prop;	! Benin
Beirlín	Nf4-Prop;	! Berlin
Beirmiúdaí	NP-PLACE-pl;	! !!!!Bermudas (The)
Beirmiúda	Nm4-Prop;	! Bermuda
Beirn	Nf4-Prop;	! Berne
Beithil	Nf2-Prop;	! Bethlehem
Bablóinia	Nf4-Prop;	! Babylonia
Bablóin	Nf2-Prop;	! Babylon
Bainglaidéis	Nf2-Prop;	! !!!!Bangla Desh
Banglaidéis	Nf2-Prop;	! !!!!Bangla Desh
Balúchastáin	Nf2-Prop;	! Baluchistan
Barbair	Nf2-Prop;	! Barbary
Bealarúis	Nf2-Prop;	! Belarus
Béóitia	Nf4-Prop;	! Boeotia
Bílearúis	Nf2-Prop;	! Byelorussia
Bitín	Nf2-Prop;	! Bithynia
Boihéim	Nf2-Prop;	! Bohemia
Boisnia-Heirseagaivéin	Nf2-Prop;	! Bosnia-Herzegovina
Boisnia	Nf4-Prop;	! Bosnia
Boróbadúr	Nm4-Prop;	! Borobudur
Botsuáin	Nf2-Prop;	! Botswana
Bratasláiv	Nf2-Prop;	! Bratislava
!!!Breatain	Nf2-Prop; !!!!Bhreatain Bheag (Wales)
Burgúin	Nf2-Prop;	! Burgundy
Burúin	Nf2-Prop;	! Burundi
Bútáin	Nf2-Prop;	! Bhutan
Biafra	Nm4-Prop;	! Biafra
Biosáint	Nf2-Prop;	! Byzantium
Boirneo	Nm4-Prop;	! Borneo
Bolaiv	Nf2-Prop;	! Bolivia
Bostún	Nm1-Prop;	! Boston
Brasaíl	Nf2-Prop;	! Brazil
Briostó	Nm4-Prop;	! Bristol
Briotáin	Nf2-Prop;	! Brittany
Bruiséil	Nf2-Prop;	! Brussels
Búcairist	Nf4-Prop;	! Bucharest
Búdaipeist	Nf4-Prop;	! Budapest
Bulgáir	Nf2-Prop;	! Bulgaria
Burma	Nm4-Prop;	! Burma
Caerdydd	NP-PLACE-sg;	! Cardiff
Caireo	Nm4-Prop;	! Cairo
Calcúta	Nm4-Prop;	! Calcutta
Camarúin	NP-PLACE-sg;	! !!!!Cameroons (The )
Camarún	Nm1-Prop;	! Cameroon
Capadóic	Nf2-Prop;	! Cappadocia
!!!!Caolas Bheiring	! !!!!Bering Straits
Beiring	Nm4-Prop;	! !!!!Bering Straits
Casacstáin	Nf2-Prop;	! Kazakhstan
Catalóin	Nf2-Prop;	! Catalonia
Catar	Nm4-Prop;	! Qatar
!!!!CATHAIR!!!!! 
Alastair	Nm4-Prop;	! Alexandria
Ailgéir		Nf2-Prop;	! Algiers Cathair na hAilgéire
Vatacáin	Nf2-Prop;	! Vatican City Cathair na Vatacáine
!!!!CATHAIR!!!!! 
Ceanada	Nm4-Prop;	! Canada
Céinia	Nf4-Prop;	! Kenya
Cairéil	Nf2-Prop;	! Karelia
Caismír	Nf2-Prop;	! Kasbmir
Caistíl	Nf2-Prop;	! Castile
Cambóid	Nf2-Prop;	! Cambodia
Campúis	Nf2-Prop;	! Kampucbea
Cartaig	Nf2-Prop;	! Carthage
Ceilibéis	Nf2-Prop;	! Celebes
Cirgeastáin	Nf2-Prop;	! Kyrgyzstan
Cianoirthear	Nm1-Prop;	! Far East !!! g. Cianoirthir
Meánoirthear	Nm1-Prop;	! Middle East
Coraint	Nf2-Prop;	! Corinth
Cordastáin	Nf2-Prop;	! Kurdistan
Cosaiv	Nf4-Prop;	! Kosovo
Crimé	Nf4-Prop;	! Crimea
Cróit	Nf2-Prop;	! Croatia
Cipir	Nf2-Prop;	! Cyprus
Cóbanhávan	Nm4-Prop;	! Copenhagen
!!!!Coilíneacht na Rinne	NP-PLACE-sg;	! !!!!Cape Colony
Cóiré	Nf4-Prop;	! Korea
Colóim	Nf2-Prop;	! Columbia
Comhlathas Nm1-Prop;
Briotanach	AdjM-Prop;	! !!!!British Commonwealth - Comhlathas Briotanach
!!!!Cónaidhm na Rúise	NP-PLACE-sg;	! !!!!Russian Federation
Cónaidhm Nf2-Prop;
Rúis	Nf2-Prop;	! !!!!Russian Federation
Congó	Nm4-Prop;	! Congo
!!!!Corn na Breataine	NP-PLACE-sg;	! Cornwall
Breatain	Nf2-Prop;	! 
Corsaic	Nf2-Prop;	! Corsica
!!!!Cósta Eabhair	NP-PLACE-sg;	! !!!!Ivory Coast
!!!!Cósta Ríce	NP-PLACE-sg;	! !!!!Costa Rica
Créit	Nf2-Prop;	! Crete
!!!!Críoch Lochlann	NP-PLACE-sg;	! Scandinavia
Cuáit	Nf4-Prop;	! Kuwait
Cúba	Nm4-Prop;	! Cuba
Dagastáin	Nf2-Prop;	! Dagestan
Dalmáit	Nf2-Prop;	! Dalmatia
Damaisc	Nf2-Prop;	! Damascos
Danmhairg	Nf2-Prop;	! Denmark
Danóib	Nf2-Prop;	! Danube
Dardainéil	Nf2-Prop;	! Dardanelles
Deilí	NP-PLACE-sg;	! Delhi
!!!!Deilí Nua	NP-PLACE-sg;	! !!!!New Delhi
Dnípir	Nf2-Prop;	! Dnieper (river)
Dnístir	Nf2-Prop;	! Dniester (river)
!!!!Dúiche na Réine	NP-PLACE-sg;	! !!!!Rhineland (The)
!!!!Dún Éideann	NP-PLACE-sg;	! Edinburgh
Eabhrac	Nm4-Prop;	! York
Eabró	Nf4-Prop;	! Ebro
Eacuadór	Nm4-Prop;	! Ecuador
Eastóin	Nf2-Prop;	! Estonia
Éigipt	Nf2-Prop;	! Egypt
Eilbe	Nf4-Prop;	! Elbe
Eilvéis	Nf2-Prop;	! Switzerland
Éimin	Nf4-Prop;	! Yemen
Eofrait	Nf2-Prop;	! Euphrates
Eoráise	Nf4-Prop;	! Eurasia
Féiníc	Nf2-Prop;	! Phoenicia
Freaslainn	Nf2-Prop;	! Friesland
Filipíneacha	NP-PLACE-sg;	! !!!!Philippines (The )
Fionlainn	Nf2-Prop;	! Finland
Flóndras	Nm4-Prop;	! Flanders
Flórans	Nm4-Prop;	! Florence (Firenze)
Frainc	Nf2-Prop;	! France
Frigia	Nf4-Prop;	! Phrygia
Gailíl	Nf2-Prop;	! Galilee
Gailís	Nf2-Prop;	! Galicia
Gaillimh	Nf2-Prop;	! Galway
Gaill	Nf2-Prop;	! Gaul
Gainséis	Nf2-Prop;	! Ganges
Galáit	Nf2-Prop;	! Galatia
Gána	Nm4-Prop;	! Ghana
!!!!Garbhchríocha na hAlban	NP-PLACE-sg;	! !!!!Scottish Highlands (The )
Geansaí	Nf4-Prop;	! Guernsey
Gearmáin	Nf2-Prop;	! Germany
Geirsí	Nf4-Prop;	! Jersey
Genova	NP-PLACE-sg;	! Genoa
Gabúin	Nf3-Prop;	! Gabon
Gaimbia	Nf4-Prop;	! Gambia
Guine 	Nf4-Prop;	! !!!!Equatorial Guinea
Mheánchriosach	AdjM-Prop;	! !!!!Equatorial Guinea - Ghuine Mheánchriosach
Ginéiv	Nf2-Prop;	! Geneva
Giobráltar	Nm4-Prop;	! Gibraltar
Glaschú	Nm4-Prop;	! Glasgow
Graonlainn	Nf2-Prop;	! Greenland
Gréig	Nf2-Prop;	! Greece
!!!!Guadalúip (agus a Spleáchríocha)	NP-PLACE-sg;	! !!!!Guadeloupe (and Dependencies)
Guáin	Nf2-Prop;	! Guyana
Gúam	NP-PLACE-sg;	! Guam
Guatamala	Nm4-Prop;	! Guatemala
!!!!Guine Bhissau	NP-PLACE-sg;	! !!!!Guinea Bissau
Guine	Nf4-Prop;	! Guinea
Háig	Nf2-Prop;	! !!!!Hague, the
Aindéis	NP-PLACE-pl;	! Andes
!!!!hAintillí, Oileáin Aintillí	NP-PLACE-sg;	! Antilles
Aipiníní	NP-PLACE-pl;	! Appenines
Háití	NP-PLACE-sg;	! Haiti
Alpa	NP-PLACE-pl;	! Alps
Asóir	NP-PLACE-pl;	! !!!!Azores (The)
Haváí	Nf4-Prop;	! Hawaii
Havána	NP-PLACE-sg;	! Havana
Heilsincí	Nf4-Prop;	! Helsinki
Himiléithe	NP-PLACE-pl;	! !!!!Himalayas (The)
!!!!hIndiacha Thoir	NP-PLACE-pl;	! !!!!East Indies
!!!!hIndiacha Thoir Thiar	NP-PLACE-sg;	! !!!!Indies (The East West)
!!!!hOileáin Bhailéaracha	NP-PLACE-sg;	! !!!!Balearic Islands (The )
Canáracha	NP-PLACE;	! !!!!Canary Islands
!!!!hOileáin Fhílipíneacha	NP-PLACE-pl;	! Philippines
Hondúras	Nm4-Prop;	! Honduras
!!!!Hong Cong	NP-PLACE-sg;	! !!!!Hong Kong
Iacúit	Nf2-Prop;	! Yakut
Iacútsc	Nm4-Prop;	! Yakutsk
Iamáice	Nf4-Prop;	! Jamaica
Iarachó	NP-PLACE-sg;	! Jericho
Iaráin	Nf2-Prop;	! Iran
Iarúsailéim	Nf2-Prop;	! Jerusalem
Iáva	Nm4-Prop;	! Java
Ibéir	Nf2-Prop;	! lberia
India	Nf4-Prop;	! India
Indinéis	Nf2-Prop;	! Indonesia
Ind-Sín	Nf2-Prop;	! Indo-China
!!!!Inis Iocht	NP-PLACE-sg;	! !!!!Wight, The Isle of
!!!!Inse Ghall	NP-PLACE-sg;	! Hebrides
!!!!Inse Orc	NP-PLACE-sg;	! !!!!Orkneys (The )
Iodáil	Nf2-Prop;	! Italy
Iodúimé	Nf4-Prop;	! Idumea
Ióhanasburg	NP-PLACE-sg;	! Johannesburg
Iondúis	Nf2-Prop;	! Indus
Iordáin	Nf2-Prop;	! Jordan
Iorua	Nf4-Prop;	! Norway
Íoslann	Nf2-Prop;	! Iceland
Iosrael	Nm4-Prop;	! Israel
Iostanbúl	Nm4-Prop;	! Istanbul
Ísiltír	Nf2-Prop;	! Netherlands ( The)
Iúgslaiv	Nf2-Prop;	! Yugoslavia
Iútlainn	Nf2-Prop;	! Jutland
Labradar	Nm4-Prop;	! Labrador
Labhráise	Nf4-Prop;	! Laurasia
Lagáin	NP-PLACE-sg;	! Lagan
Laitvia	Nf4-Prop;	! Latvia
Laoi	Nf4-Prop;	! Lee
Laos	NP-PLACE-sg;	! Laos
Laplainn	Nf2-Prop;	! Lapland
Iaráic	Nf2-Prop;	! Iraq
Learpholl	Nm1-Prop;	! Liverpool
!!!!Leithinis Bhalcánach	NP-PLACE-sg;	! !!!!Balkan Peninsula
!!!!Leithinis Mhalae	NP-PLACE-sg;	! !!!!Malay Peninsulà
Leiveaint	Nf2-Prop;	! Levant (The )
Leódhas	Nm4-Prop;	! Lewis Island
Leosóta	Nm4-Prop;	! Lesotho
Libéir	Nf2-Prop;	! Liberia
Libia	Nf4-Prop;	! Libya
Lichtinstéin	Nf4-Prop;	! Liechtenstein
Licia	Nf4-Prop;	! Lycia
Life	Nf4-Prop;	! Liffey
Liobáin	Nf2-Prop;	! Lebanon
Liospóin	Nf2-Prop;	! Lisbon
Liotuáin	Nf2-Prop;	! Lithuania
!!!!Loch Cuan	NP-PLACE-sg;	! !!!!Strangford Lough
!!!!Loch Dearg	NP-PLACE-sg;	! !!!!Lough Derg
!!!!Loch Deirgeirt	NP-PLACE-sg;	! !!!!Lough Derg
!!!!Loch Eirne	NP-PLACE-sg;	! !!!!Lough Erne
!!!!Loch Lao	NP-PLACE-sg;	! !!!!Belfast Lough
!!!!Loch nEathach	NP-PLACE-sg;	! !!!!Lough Neagh
Lombaird	Nf2-Prop;	! Lombardy
Lorráin	Nf2-Prop;	! Lorraine
Lováin	Nf4-Prop;	! Louvain
Lucsamburg	Nm4-Prop;	! Luxembourg
Luimneach	Nm1-Prop;	! Limerick
Madagascar	NP-PLACE-sg;	! Madagascar
Maidéara	Nm4-Prop;	! Madeira
Maidrid	Nf4-Prop;	! Madrid
Mailí	Nf4-Prop;	! Mali
Mainile	Nf4-Prop;	! Manila
Malaeisia	Nf4-Prop;	! Malaysia
Mallarca	Nm4-Prop;	! Majorca
Málta	Nm4-Prop;	! Malta
Manainn	Nf2-Prop;	! Man, Isle of
Manchain	Nf4-Prop;	! Manchester
Maracó	Nm4-Prop;	! Morocco
Meice	Nf4-Prop;	! Mecca
Meicsiceo	Nm4-Prop;	! Mexico
Meilinéis	Nf2-Prop;	! Melanesia
!!!!Meiriceá Laidineach	Nm4-Prop;	! !!!!Latin America
Macadóin	Nf4-Prop;	! Macedonia
Maláiv		Nf4-Prop;	! Malawi
Manchúir	Nf4-Prop;	! Manchuria
Máratáin	Nf2-Prop;	! Mauritania
Meánmhuir	Nf3-Prop;	! !!!!Mediterranean Sea
Measpatáim	Nf2-Prop;	! Mesopotamia
Micrinéis	Nf2-Prop;	! Micronesia
Moldóiv	Nf4-Prop;	! Moldova
!!!!Mhuir Bhailéarach	NP-PLACE-sg;	! !!!!Balearic Sea
!!!!Mhuir Bhailt	NP-PLACE-sg;	! !!!!Baltic Sea (The )
!!!!Mhuir Bhuí	NP-PLACE-sg;	! !!!!Yellow Sea (The)
!!!!Mhuir Chairib	NP-PLACE-sg;	! !!!!Caribbean Sea
!!!!Mhuir Cheilteach	Nf3-Prop;	! !!!!Celtic Sea
!!!!Mhuir Dhubh	Nf3-Prop;	! !!!!Black Sea
!!!!Mhuir Mharbh	Nf3-Prop;	! !!!!Dead Sea
!!!!Mhuir Mheann, Muir Eireann	NP-PLACE-sg;	! !!!!Irish Sea (The)
!!!!Mhuir Mheoid	NP-PLACE-sg;	! !!!!Azov (Sea of)
!!!!Mhuir Rua	Nf3-Prop;	! !!!!Red Sea
!!!!Mhuir Rua	NP-PLACE-sg;	! !!!!Red Sea (The )
!!!!Mhuir Shargasach	NP-PLACE-sg;	! !!!!Sargasso Sea (The )
!!!!Mhuir Thuaidh	Nf3-Prop;	! !!!!North Sea
!!!!Mhuir Thuaidh	NP-PLACE-sg;	! !!!!North Sea (The )
Mionarca	Nm4-Prop;	! Minorca
Molacaí	NP-PLACE-pl;	! !!!!Molucca Islands (The)
Moldáiv	Nf2-Prop;	! Moldavia
Valáic-Mholdáiv	Nf2-Prop;	! Wallacia-Moldavia
Valáic	Nf2-Prop;	! Wallacia
Monacó	Nm4-Prop;	! Monaco
Mongóil	Nf2-Prop;	! Mongolia
Montainéagró	Nm4-Prop;	! Montenegro
Montsarat	Nm4-Prop;	! Montserrat
Moráiv	Nf2-Prop;	! Moravia
Mordóiv	Nf2-Prop;	! Mordovia
Mósaimbíc	Nf2-Prop;	! Mozambique
Moscó	Nm4-Prop;	! Moscow
!!!!Muir Bhailt	NP-PLACE-sg;	! !!!!Baltic Sea
!!!!Muir Bhreatan	NP-PLACE-sg;	! !!!!Saint George's Channel
!!!!Muir Bhreatan	NP-PLACE-sg;	! !!!!St George's Channel
!!!!Muir Chairib	NP-PLACE-sg;	! !!!!Carribean Sea
!!!!Muir Chaisp	NP-PLACE-sg;	! !!!!Caspian Sea
!!!!Muir Éireann	NP-PLACE-sg;	! !!!!Irish Sea
!!!!Muir Meann	NP-PLACE-sg;	! !!!!Irish Sea
!!!!Muir na Gailíle	NP-PLACE-sg;	! !!!!Galillee (Sea of)
!!!!Muir nIocht	NP-PLACE-sg;	! !!!!English Channel
!!!!Muir Thoirian	NP-PLACE-sg;	! !!!!Tyrhhenian Sea
!!!!Murascaill Mheicsiceo	NP-PLACE-sg;	! !!!!Gulf of Mexico
!!!!Murascaill na Peirse	NP-PLACE-sg;	! !!!!Persian Gulf
!!!!Murascaill na Peirse	NP-PLACE-sg;	! !!!!Persian Gulf (The )
Muscat	NP-PLACE-sg;	! Muscat
!!!!Na hOileáin Mhaildíve	NP-PLACE-sg;	! !!!!Maldive Islands (The )
Namaib	Nf2-Prop;	! Namibia
Nárú	Nm4-Prop;	! Naura
Nasaireit	NP-PLACE-sg;	! Nazareth
Natal	NP-PLACE-sg;	! Natal
Neipeál	NP-PLACE-sg;	! Nepal
Niasalainn	Nf2-Prop;	! Nyasaland
Nicearagua	Nm4-Prop;	! Nicaragua
Nigéir	Nf2-Prop;	! Nigeria
Nígir	Nf2-Prop;	! Niger
Normainn	Nf2-Prop;	! Normandy
Nua-Eabhrac	Nm4-Prop;	! New York
Nua-Ghuíne	Nf4-Prop;	! !!!!New Guinea
Nua-Shéalainn	Nf2-Prop;	! !!!!New Zealand
!!!!OILEÁIN!!!!! 
Ailiúit	NP-PLACE-pl;	! O. Ailiúit - Aleutian Islands
Comóra	NP-PLACE-sg;	! !!!!Comoro Islands
Fáclann	Nf2-Prop;	! !!!!Falkland Islands
Faró	Nm4-Prop;	! !!!!Faroe Islands
Fidsí	NP-PLACE-sg;	! !!!!Fiji Islands
Maildíve	NP-PLACE-sg;	! !!!!Maldive Islands (The )
!!!!Oileáin Mhuir nIocht	NP-PLACE-sg;	! !!!!Channel Islands
Aimiréalacht	Nf3-Prop;	! !!!!Admirality Islands
Manann	NP-PLACE-sg;	! !!!!Isle of Man
Muirís	NP-PLACE-sg;	! Mauritius
Deascabháil	Nf3-Prop;	! !!!!Ascension Island
Tobága	Nm4-Prop;	! !!!!Trinidad and Tobago
Oiséit	Nf2-Prop;	! Ossetia
Ollainn	Nf2-Prop;	! Holland
Oman	NP-PLACE-sg;	! Oman
Oranócó	Nf4-Prop;	! Orinoco
Osló	Nm4-Prop;	! Oslo
Ostainn	Nf4-Prop;	! Ostend
Ostair	Nf2-Prop;	! Austria
Pacastáín	Nf2-Prop;	! Pakistan
Palaistín	Nf2-Prop;	! Palestine
Panama	Nm4-Prop;	! Panama
Papua	Nm4-Prop;	! Papua
Paragua	Nm4-Prop;	! Paraguay
Páras	Nm4-Prop;	! Paris
Péicing	Nf4-Prop;	! Peking
Béising	Nf4-Prop;	! Beijing
Peiriú	Nm4-Prop;	! Peru
Patagóin	Nf4-Prop;	! Patagonia
Portaingéil	Nf2-Prop;	! Portugal
Malagásach	NP-PLACE-sg;	! !!!!Malagasy Republic
Polainéis	Nf2-Prop;	! Polynesia
Pó		Nf4-Prop;	! Po
Pontmhuir	Nf3-Prop;	! !!!!Pontian Sea
Prúis		Nf4-Prop;	! Prussia
Puinseaib	Nf4-Prop;	! Punjab
Piréiní	NP-PLACE-pl;	! Pyrenees
Seic	Nf2-Prop;	! !!!!Czech Republic (The )
Volta	NP-PLACE-fem;	! !!!!Voltaic Republic
Polainn	Nf2-Prop;	! Poland
Portaingéíl	Nf2-Prop;	! Portugal
!!!!Port Láirge	NP-PLACE-sg;	! Waterford
!!!!Portó Ríce	NP-PLACE-sg;	! !!!!Puerto Rico
Prág	NP-PLACE-sg;	! Prague
!!!!Prionsacht Mhónacó	NP-PLACE-sg;	! !!!!Principality of Monaco
Réin	Nf2-Prop;	! Rhine
!!!!Rinn an Choirn	NP-PLACE-sg;	! !!!!Cape Horn
!!!!Rinn an Dóchais	NP-PLACE-sg;	! !!!!Cape of Good Hope
!!!!Riocht Aontaithe	Nf3-Prop;	! !!!!United Kingdom
!!!!Ríocht Aontaithe	NP-PLACE-sg;	! !!!!United Kinglom
Rivéara	NP-PLACE-sg;	! !!!!Riviera (The )
Ródas	NP-PLACE-sg;	! Rhodes
Róidéis	NP-PLACE-sg;	! Rhodesia
Róimh	Nf2-Prop;	! Rome
Róin	NP-PLACE-sg;	! Rhone
Rómáin	Nf2-Prop;	! Romania
Rómáin	NP-PLACE-sg;	! Rumania
Ruanda	NP-PLACE-sg;	! Rwanda
Rúis	Nf2-Prop;	! Russia
Sahára	Nm4-Prop;	! Sahara
Saimbéis	NP-PLACE-sg;	! Zambesi
Saimbia	Nf4-Prop;	! Zambia
Sainsibeár	NP-PLACE-sg;	! Zanzibar
Sairdín	Nf2-Prop;	! Sardinia
Sáír	Nf2-Prop;	! Zaire
Salvadóir	Nf2-Prop;	! !!!!El Salvador
Samáir	NP-PLACE-sg;	! Samaria
Samó	NP-PLACE-sg;	! Samoa
!!!!Samó Thiar	NP-PLACE-sg;	! !!!!Western Samoa
!!!!San Héilin	NP-PLACE-sg;	! !!!!Saint Helena
!!!!San Mairíne	NP-PLACE-sg;	! !!!!San Marino
Sasana	Nm4-Prop;	! England
Sceilt	Nf2-Prop;	! Scheldt
Scillí	NP-PLACE-sg;	! !!!!Scilly Islands (The)
Sead	Nm4-Prop;	! Chad
Séalainn	NP-PLACE-sg;	! Zealand
Sealtainn	NP-PLACE-pl;	! Shetlands
Seapáin	Nf2-Prop;	! Japan
Seicslóvaic	Nf2-Prop;	! Czechoslovakia
Seineagáil	Nf2-Prop;	! Senegal
Séin	NP-PLACE-sg;	! Seine
Seirbia	Nf4-Prop;	! Serbia
Seisnia	Nf4-Prop;	! Chechnia
Seoirsia	Nf4-Prop;	! Georgia
!!!!Siarra Leon	NP-PLACE-sg;	! !!!!Sierra Leone
Sibéir	Nf2-Prop;	! Siberia
Sicil	Nf2-Prop;	! Sicily
Sile	Nf4-Prop;	! Chile
Singeapór	Nm4-Prop;	! Singapore
Sín	Nf2-Prop;	! China
Siombáib	Nf2-Prop;	! Zimbabwe
Sionainn	Nf2-Prop;	! Shannon
Sionainn	Nf2-Prop;	! !!!!Shannon (The )
Siria	Nf4-Prop;	! Syria
!!!!Sléibhte Apaláiseacha	NP-PLACE-sg;	! !!!!Appalachian Mountains
!!!!Sléibhte Atlais	NP-PLACE-sg;	! !!!!Atlas Mountains
!!!!Sléibhte Cairp	NP-PLACE-sg;	! !!!!Carpathian Mountains
!!!!Sléibhte Creagacha	NP-PLACE-sg;	! !!!!RockyMountains (The)
!!!!Sléibhte Cugais	NP-PLACE-sg;	! !!!!Caucasus Mountains
!!!!Sléibhte na hÚraile	NP-PLACE-sg;	! !!!!Ural Mountains (The)
Slóivéin	Nf2-Prop;	! Slovenia
Slóvaic	Nf2-Prop;	! Slovakia
Sóifia	NP-PLACE-sg;	! Sophia
Somáil	Nf2-Prop;	! Somalie
Spáinn	Nf2-Prop;	! Spain
!!!!Srí Lanca	NP-PLACE-sg;	! !!!!Sri Lanka
!!!!Sruth na Maoíle	NP-PLACE-sg;	! !!!!North Channel
!!!!Sruth na Maoile	NP-PLACE-sg;	! !!!!North Channel (The)
!!!!Stáit Aontaithe Mheiríceá	NP-PLACE-sg;	! !!!!United States of America
!!!!Stáit Aontaithe Mheiriceá (SAM)	NP-PLACE-sg;	! !!!!United States of America (USA)
!!!!Stáit Bhalcánacha	NP-PLACE-sg;	! !!!!Balkan States
!!!!Stát Chathair na Vatacáine	NP-PLACE-sg;	! !!!!Vatican City State
Stócólm	NP-PLACE-sg;	! Stockholm
Suais	NP-PLACE-sg;	! Duez
Sualainn	Nf2-Prop;	! Sweden
Suasalainn	NP-PLACE-sg;	! Swaziland
Súdáin	Nf2-Prop;	! Sudan
Súlúlainn	NP-PLACE-sg;	! Zululand
Táidsíceastáin	NP-PLACE-sg;	! Tajikistan
!!!!Aigéan
Aigéan 	Nm1-Prop;	! !!!!Antarctic Ocean
Antartach	AdjM-Prop;	! !!!!Antarctic Ocean
Artach		AdjM-Prop;	! !!!!Arctic Ocean
Atlantach	AdjM-Prop;	! !!!!Atlantic Ocean
Ciúin		AdjM-Prop;	! !!!!Pacific Ocean
Indiach		AdjM-Prop;	! !!!!Indian Ocean
Taihítí	NP-PLACE-sg;	! Tahiti
!!!!Talamh an Éisc	NP-PLACE-sg;	! Newfoundland
!!!!Talamh Naofa	Nm1-Prop;	! !!!!Holy Land
Tamais	NP-PLACE-sg;	! Thames
Tansáin	Nf2-Prop;	! Tanzania
Antartach	Nm1-Prop;	! Antarctic
Artach	Nm1-Prop;	! Arctic
Tartair	NP-PLACE-sg;	! Tartary
Tasmáin	Nf2-Prop;	! Tasmania
Atlantach	Nm1-Prop;	! !!!!Atlantic Ocean
Téalainn	Nf2-Prop;	! Thailand
Teasáil	Nf2-Prop;	! Thessaly
Téaváin	NP-PLACE-sg;	! Taiwan
Tibéid	Nf2-Prop;	! Tibet
Tibir	Nf2-Prop;	! Tiber
Tígris	NP-PLACE-sg;	! Tigris
Tíomór	NP-PLACE-sg;	! Timor
!!!!Tíomór Thoir	NP-PLACE-sg;	! !!!!East Timor
Tioról	NP-PLACE-sg;	! Tyrol
!!!!Tíortha faoi Thoinn	NP-PLACE-sg;	! !!!!Low Countries (The)
!!!!Tír Bheannaithe	Nf2-Prop;	! !!!!Holy Land
Tobága	NP-PLACE-sg;	! Tobago
Tógo	NP-PLACE-sg;	! Togo
Tóiceo	NP-PLACE-sg;	! Tokyo
Tonga	NP-PLACE-sg;	! Tonga
Traí	NP-PLACE-sg;	! Troy
Tripilí	NP-PLACE-sg;	! Tripoli
Túinéis	Nf2-Prop;	! Tunisia
Túinis	Nf4-Prop;	! Tunis
Tuirc	Nf2-Prop;	! Turkey
Turcastáin	Nf2-Prop;	! Turkenstan
Tuscáin	Nf2-Prop;	! Tuscany
Úcráin	Nf2-Prop;	! Ukraine
Udmairt	Nf4-Prop;	! Udmurt
Uganda	Nm4-Prop;	! Uganda
Úisbéiceastáin	Nf2-Prop;	! Uzbekistan
Ungáir	Nf2-Prop;	! Hungary
Uragua	Nm4-Prop;	! Uruguay
Úrail	Nf2-Prop;	! !!!!Ural (The River)
Vársá	Nm4-Prop;	! Warsaw
Veinéis	Nf2-Prop;	! Venice
Veiniséala	Nm4-Prop;	! Venezuela
Vín	Nf4-Prop;	! Vienna
Vítneam	Nm4-Prop;	! Vietnam
Vítneam	NP-PLACE-sg;	! Viet-Nam
Volga	NP-PLACE-sg;	! Volga
Volta	NP-PLACE-sg;	! !!!!Volta River (The)
Vóvaidín	NP-PLACE-sg;	! Vojvodina
